stretching	1.n. 伸长；展宽 2.v. 拉伸（stretch的ing形式） 
inhabitants	1.n. 居民（inhabitant的复数） 
emergence	1.n. 出现，浮现；发生；露头 
urging	1.v. 说服，催促；激励，驱策；清除（urge的ing形式） 
patrol	1.n. 巡逻；巡逻队；侦察队 2.vt. 巡逻；巡查 3.vi. 巡逻；巡查 
Netflix	1.n. 网飞公司 
Alexis	1.n. 亚历克西斯（男子名） 
fast-growing	1.adj. 快速发展的
pledges	1.n. 保证，誓言；抵押；抵押品，典当物 2.vt. 保证，许诺；用……抵押；举杯祝……健康 3.n. (Pledge)人名；(英)普莱奇 
priests	1.n. 祭司；牧师；神父；教士（priest的复数） 
Aires	1.n. 白羊座 
Abbas	1.n. 阿巴斯（地名，伊朗最大港口）；阿巴斯王朝 
Kennedy	1.n. 肯尼迪（姓氏，美国第35任总统） 
diesel	1.n. 柴油机；柴油；（俚）健康的身体 2.adj. 内燃机传动的；供内燃机用的 3.n. (Diesel)人名；(德)狄塞耳 4.n. 迪赛（意大利时装品牌） 
partial	1.adj. 局部的；偏爱的；不公平的 
Miller	1.n. 磨坊主；碾磨工；蛾 2.n. (Miller)人名；(西、葡)米列尔；(英、德、法、爱沙、芬、罗、瑞典、波)米勒 
disproportionately	1.adv. 不成比例地 
Jacob	1.n. 雅各（以色列人的祖先）；雅各布（男子名） 
specifically	1.adv. 特别地；明确地 
nationally	1.adv. 全国性地；以国民立场地；举国一致地 
restricted	1.v. 限制（restrict的过去式和过去分词） 2.adj. 受限制的；保密的 
recommended	1.v. 推荐，介绍；建议（recommend的过去分词） 2.adj. 被推荐的 
awful	1.adj. 可怕的；极坏的；使人敬畏的 
shelves	1.n. 架子（shelf 的复数） 2.v. 装架（shelve的第三人称单数形式） 
disgruntled	1.adj. 不满的；不高兴的 
representation	1.n. 代表；表现；表示法；陈述 
precious	1.adj. 宝贵的；珍贵的；矫揉造作的 2.n. (Precious)人名；(英)普雷舍斯，普雷舍丝(女名) 
questioned	1.v. 怀疑；询问（question的过去分词） 2.adj. 怀疑的；有问题的；有争议的 
plunge	1.n. 投入；跳进 2.vt. 使陷入；使投入；使插入 3.vi. 突然地下降；投入；陷入；跳进 
stimulate	1.vi. 起刺激作用；起促进作用 2.vt. 刺激；鼓舞，激励 
cooling	1.n. 冷却 2.adj. 冷却的 3.n. (Cooling)人名；(英)库林 
wartime	1.n. 战时 
geopolitical	1.adj. 地理政治学的 
annually	1.adv. 每年；一年一次 
origins	1.n. 起源（origin的复数） 
brink	1.n. （峭壁的）边缘 2.n. (Brink)人名；(德、英、荷、丹、瑞典)布林克 
displaced	1.n. 无家可归者 2.v. 取代（displace的过去分词）；移动…的位置；撤换 3.adj. 无家可归的；位移的；被取代的 
Sochi	1.n. 索契（苏联城市） 
proxy	1.n. 代理人；委托书；代用品 
spite	1.n. 不顾；恶意；怨恨 2.vt. 刁难；使恼怒 
Mandela	1.曼德拉（人名） 
fires	1.n. [安全] 火灾，点火；[军] 火力 
prestigious	1.adj. 有名望的；享有声望的 
Sinn	1.辛恩（手表品牌） 
deliberately	1.adv. 故意地；谨慎地；慎重地 
resident	1.n. 居民 2.adj. 居住的；住院医师；定居的 
large-scale	1.adj. 大规模的，大范围的；大比例尺的 
objections	1.n. 反对，异议（objection的复数形式）；反对意见 
explosion	1.n. 爆炸；爆发；激增 
founders	1.n. 创办人；造物者（founder的复数） 
essentially	1.adv. 本质上；本来 
silicon	1.n. [化学] 硅；硅元素 
molecules	1.n. [化学] 分子，微粒；[化学] 摩尔（molecule的复数） 
diabetes	1.n. 糖尿病；多尿症 
lacking	1.v. 缺少；不足（lack的ing形式） 2.adj. 缺乏的；没有的；不足的 
defended	1.[法] 辩护 
revive	1.vt. 使复兴；使苏醒；回想起；重演，重播 2.vi. 复兴；复活；苏醒；恢复精神 
Jakarta	1.n. 雅加达（印尼首都，等于Djakarta） 
cigarettes	1.n. 香烟，[轻] 卷烟（cigarette的复数） 
stepping	1.n. 步进；改变；分级；通过透镜天线后波前的取平 2.v. 踏；以步测量（step的ing形式） 
solidarity	1.n. 团结，团结一致 
breakthrough	1.n. 突破；突破性进展 
Eventually	1.adv. 最后，终于 
applying	1.vt. apply的变形 
biology	1.n. （一个地区全部的）生物；生物学 
beliefs	1.n. 信仰；信念（belief的复数） 
grasp	1.n. 抓住；理解；控制 2.vi. 抓 3.vt. 抓住；领会 
myth	1.n. 神话；虚构的人，虚构的事 
crossed	1.v. 交叉；越过（cross的过去式和过去分词） 2.adj. 交叉的；划掉的；十字形的 
armoured	1.adj. 装甲的；铠装的；蛇皮管的 
beating	1.n. 打；[纸] 打浆；敲打；失败 2.v. 打（beat的ing形式） 
persuading	1.v. 劝说（persuade的ing形式） 
pipelines	1.n. [建] 管道（pipeline的复数）；管线；管道运输业 2.v. 用管道输送；应用流水线技术设计（pipeline的三单形式） 
discussed	1.v. 讨论（discuss的过去分词）；商讨 
Asians	1.n. 亚洲人（Asian的复数） 
fleet	1.n. 舰队；港湾；小河 2.adj. 快速的，敏捷的 3.vt. 消磨 4.vi. 飞逝；疾驰；掠过 5.n. (Fleet)人名；(英)弗利特 
discussing	1.论述 
successive	1.adj. 连续的；继承的；依次的；接替的 
objective	1.n. 目的；目标；[光] 物镜；宾格 2.adj. 客观的；目标的；宾格的 
organisers	
studio	1.n. 工作室；[广播][电视] 演播室；画室；电影制片厂 
Shabab	1.n. 青年党 
doctrine	1.n. 主义；学说；教义；信条 
depression	1.n. 沮丧；洼地；不景气；忧愁 
Berkshire	1.n. 伯克郡（英国南部一郡）；黑白色的猪 
Carter	1.n. 运货马车夫，驾驶货车的人 
Shinawatra	
spooks	1.n. 幽灵（spook的复数形式） 
questionable	1.adj. 可疑的；有问题的 
describing	1.v. 描述；表示（describe的ing形式） 2.adj. 描述的 
bureaucratic	1.adj. 官僚的；官僚政治的 
bay	1.n. 海湾；狗吠声 2.vt. 向…吠叫 3.vi. 吠叫；大声叫嚷 4.n. (Bay)人名；(越)七；(英、老)贝；(德、意、罗、捷、土、丹)巴伊；(匈)鲍伊；(瑞典)巴伊 
furious	1.adj. 激烈的；狂怒的；热烈兴奋的；喧闹的 
part-time	1.adj. 兼职的；部分时间的 2.adv. 兼职地；用部分时间地 
marine	1.n. 海运业；舰队；水兵；（海军）士兵或军官 2.adj. 船舶的；海生的；海产的；航海的，海运的 3.n. (Marine)人名；(西)马里内；(英)马林 
rape	1.n. 强奸，掠夺；[园艺] 油菜；葡萄渣 2.vt. 强奸；掠夺，抢夺 3.vi. 犯强奸罪 
knowing	1.n. 认知 2.v. 知道；认识；确信（know的ing形式） 3.adj. 博学的；狡猾的；心照不宣的 
restored	1.v. 修复（restore的过去式）；恢复健康 2.adj. 精力充沛的；精力恢复的 
crunch	1.n. 咬碎，咬碎声；扎扎地踏 2.vt. 压碎；嘎扎嘎扎的咬嚼；扎扎地踏过 3.vi. 嘎吱作响地咀嚼；嘎吱嘎吱地踏过 
Fannie	1.n. 房利美（房产经济公司）；范妮（女子名，等于Frances） 
longer-term	
colleague	1.n. 同事，同僚 
Alaska	1.n. 阿拉斯加州 
Maryland	1.n. 马里兰（美国州名） 
maintaining	1.n. 维护；保养 2.v. 维持；保养（maintain的ing形式） 
Havana	1.n. 哈瓦那（古巴城市）；哈瓦那雪茄烟 
meagre	1.adj. 瘦的；贫弱的；贫乏的 
investigated	1.v. 研究（investigate的过去分词）；调查 2.adj. 研究的；调查的 
pursuit	1.n. 追赶，追求；职业，工作 
evil	1.n. 罪恶，邪恶；不幸 2.adj. 邪恶的；不幸的；有害的；讨厌的 
newcomers	1.n. 新来的人（newcomer的复数） 
broadcaster	1.n. 广播公司；广播员；播送设备；撒播物 
Following	1.n. 下列事物；一批追随者 2.v. 跟随；沿行（follow的ing形式） 3.adj. 下面的；其次的，接着的 
thick	1.n. 最拥挤部分；活动最多部分；事物的粗大浓密部分 2.adj. 厚的；浓的；粗大的 3.adv. 密集地；浓浓地，厚厚地 4.n. (Thick)人名；(英)西克 
barricade	1.n. 街垒；路障；争论之处 2.vt. 设路障；阻碍 
attending	1.adj. （医生）主治的 2.v. 参加（attend的现在分词）；注意，听；照顾；[常用被动语态]（作为结果、情况）伴随 
reassure	1.vt. 使…安心，使消除疑虑 
second-biggest	
acknowledges	1.v. 承认（acknowledge的第三人称单数形式） 
stressed	1.v. 强调（stress的过去分词）；给…加压力 2.adj. 紧张的；感到有压力的 
Poles	1.n. 极点（pole的复数形式）；雪杖；杆位次数 2.n. (Poles)人名；(德、捷)波勒斯 
patronage	1.n. 赞助；光顾；任免权 
Strasbourg	1.n. 斯特拉斯堡（法国东北部城市） 
Sturgeon	1.n. 鲟鱼 2.n. (Sturgeon)人名；(英)斯特金 
immigrant	1.n. 移民，侨民 2.adj. 移民的；迁入的 
irrelevant	1.adj. 不相干的；不切题的 
bribery	1.n. [法] 贿赂；受贿；行贿 
attempting	1.n. 企图，试图；攻击 2.vt. 企图，试图；尝试 
effectiveness	1.n. 效力 
accidents	1.n. [安全] 事故（accident的复数）；[安全] 意外事故 
switching	1.n. [电] 开关；转换；整流；配电 2.v. 转换（switch的ing形式） 
publishers	1.n. 出版商，出版公司；出版社（publisher的复数） 
Property	1.n. 性质，性能；财产；所有权 
renewables	1.n. 可再生能源（renewable的复数） 
foster	1.vt. 培养；养育，抚育；抱（希望等） 2.adj. 收养的，养育的 3.n. (Foster)人名；(英、捷、意、葡、法、德、俄、西)福斯特 
Marco	1.n. 马尔科（人名）；显示地图；展现地图 
merchants	1.n. [贸易] 商人（merchant的复数） 
suburban	1.n. 郊区居民 2.adj. 郊区的，城郊的；土气的；见闻不广的 
drift	1.n. 漂流，漂移；趋势；漂流物 2.vi. 漂流，漂移；漂泊 3.vt. 使…漂流；使…受风吹积 
Campos	1.n. 热带草原 2.n. (Campos)人名；(法、西、葡、英)坎波斯 
scarcely	1.adv. 几乎不，简直不；简直没有 
reconciliation	1.n. 和解；调和；和谐；甘愿 
Gary	
confusion	1.n. 混淆，混乱；困惑 
employer	1.n. 雇主，老板 
accusing	1.v. 指责；指控（accuse的ing形式） 2.adj. 指责的；非难的；归咎的 
translation	1.n. 翻译；译文；转化；调任 
Cristina	1.n. 克里斯蒂娜（电视剧中的人物） 
taxation	1.n. 课税，征税；税款 
Seoul	1.n. 汉城，首尔（韩国首都） 
refer	1.vt. 涉及；委托；归诸于；使…求助于 2.vi. 参考；涉及；提到；查阅 
hatred	1.n. 憎恨；怨恨；敌意 
duly	1.adv. 适当地；充分地；按时地 2.n. (Duly)人名；(英)杜利 
referring	1.v. 谈及；提交；谘询（refer的ing形式） 
opposing	1.v. 反对（oppose的ing形式） 2.adj. 反对的；相对的；对面的 
confront	1.vt. 面对；遭遇；比较 
disappointment	
sake	1.n. 目的；利益；理由；日本米酒 2.n. (Sake)人名；(罗)萨克；(日)酒(姓) 
subtle	1.adj. 微妙的；精细的；敏感的；狡猾的；稀薄的 
communication	1.n. 通讯，[通信] 通信；交流 
Burmese	1.n. 缅甸人；缅甸语 2.adj. 缅甸的；缅甸人的；缅甸语的 
pundit	1.n. 博学者；梵文学者 
consortium	1.n. 财团；联合；合伙 
pocket	1.n. 口袋；钱；容器 2.adj. 小型的，袖珍的；金钱上的 3.vt. 隐藏；忍受；将…放入衣袋 4.vi. 形成袋或囊 
opt	1.vi. 选择 
distinction	1.n. 区别；差别；特性；荣誉、勋章 
nightmare	1.n. 恶梦；梦魇般的经历 2.adj. 可怕的；噩梦似的 
Criminal	1.n. 罪犯 2.adj. 刑事的；犯罪的；罪恶的 
employee	1.n. 雇员；从业员工 
Piketty	1.n. (Piketty)人名；(法)皮凯蒂 
Italia	1.n. 意大利 
lesser	1.adj. 较少的；次要的；更小的 2.adv. 较少地；更小地；不及 3.n. (Lesser)人名；(英、德)莱塞 
pursuing	1.n. 追求；追逐；追赶 2.v. 从事；追赶（pursue的ing形式） 
mayoral	1.adj. 市长的 2.n. (Mayoral)人名；(西)马约拉尔 
Christianity	1.n. 基督教；基督教精神，基督教教义 
Soon	1.adv. 快；不久，一会儿；立刻；宁愿 
cops	1.n. 警察（cop的复数）；顶；纬管 2.v. 抓住；受贿；偷窃（cop的三单形式） 
curious	1.adj. 好奇的，有求知欲的；古怪的；爱挑剔的 
writers	1.n. 作家；[图情] 作者（writer的复数） 
weaknesses	1.n. 劣势，弱点；[审计] 薄弱环节（weakness的复数形式） 
crown	1.n. 王冠；花冠；王权；顶点 2.vt. 加冕；居…之顶；表彰；使圆满完成 3.n. (Crown)人名；(英)克朗 
raid	1.n. 袭击；突袭；搜捕；抢劫 2.vt. 袭击，突袭 3.vi. 对…进行突然袭击 4.n. (Raid)人名；(阿拉伯)拉伊德 
Savarkar	
humanitarian	1.n. 人道主义者；慈善家；博爱主义者；基督凡人论者 2.adj. 人道主义的；博爱的；基督凡人论的 
Salman	1.n. 萨尔曼（男子名） 
wholly	1.adv. 完全地；全部；统统 
disruptive	1.adj. 破坏的；分裂性的；制造混乱的 
reliant	1.adj. 依赖的；可靠的；信赖的 
Blasio	1.n. (Blasio)人名；(意、英)布拉西奥 
notorious	1.adj. 声名狼藉的，臭名昭著的 
curbing	1.n. 边石的材料；边石 
Institution	1.n. 制度；建立；（社会或宗教等）公共机构；习俗 
exceptions	1.n. 免责条款（exception的复数形式） 
charismatic	1.adj. 超凡魅力的；神赐能力的 
intervention	1.n. 介入；调停；妨碍 
Vestager	
Amnesty	1.n. 大赦，特赦 2.vt. 对…实行大赦 
Initiative	1.n. 主动权；首创精神 2.adj. 主动的；自发的；起始的 
Peshmerga	
Mecca	1.n. 麦加（沙特阿拉伯一座城市）；众人渴望去的地方 
Ackman	
Internal	1.adj. 内部的；内在的；国内的 
NCAA	1.abbr. （美国）全国大学生体育协会（National Collegiate Athletic Association） 
fibres	1.n. [材] 纤维；[植] 须根（fibre的复数） 
convergence	1.n. [数] 收敛；会聚，集合 2.n. (Convergence)人名；(法)孔韦尔让斯 
healthcare	1.n. 医疗保健；健康护理，健康服务；卫生保健 
gunmen	1.n. 枪手；制造枪械者；持枪的歹徒 
Michelle	1.n. 米歇尔（女子名） 
concede	1.vi. 让步 2.vt. 承认；退让；给予，容许 
pending	1.prep. 在…期间；直到…时为止；在等待…之际 2.v. 待定；悬而不决（pend的ing形式） 3.adj. 未决定的；行将发生的 4.n. (Pending)人名；(瑞典)彭丁 
Noble	1.n. 贵族 2.adj. 高尚的；贵族的；惰性的；宏伟的 3.vt. 抓住；逮捕 4.n. (Noble)人名；(英、法、意)诺布尔；(西)诺夫莱；(阿拉伯)努布莱 
slashing	1.n. 猛砍；鞭打 2.adj. 猛烈的；严厉的；冲劲十足的；巨大的 
Eurosceptics	
traffickers	1.n. 贩毒者（trafficker的复数） 
responsibilities	1.n. 责任；职责（responsibility的复数） 
hacking	1.v. 砍；出租（hack的ing形式） 2.adj. 骑马的 3.n. (Hacking)人名；(英)哈金 
males	1.n. 雄性（male的复数）；壮丁 2.n. (Males)人名；(罗)马莱斯 
pervasive	1.adj. 普遍的；到处渗透的；流行的 
fabric	1.n. 织物；布；组织；构造；建筑物 
non-financial	1.非财务性的，非金融类的 
triggering	1.n. [电子] 触发；起动 2.v. 引起（trigger的ing形式）；扣…的扳机 
facto	1.adj. 事实上的，实际上的 
cult	1.n. 祭仪（尤其指宗教上的）；礼拜；狂热信徒 2.adj. 狂热崇拜的 
liable	1.adj. 有责任的，有义务的；应受罚的；有…倾向的；易…的 
assigned	1.v. 分配（assign的过去分词）；指定；委派 2.adj. 指定的；已分配的 
superior	1.n. 上级，长官；优胜者，高手；长者 2.adj. 上级的；优秀的，出众的；高傲的 
Progressive	1.n. 改革论者；进步分子 2.adj. 进步的；先进的 
outsourcing	1.n. 外包；外购；外部采办 
norms	1.n. [标准] 标准，规范；基准（norm复数形式） 
tangled	1.adj. 紊乱的；纠缠的；缠结的；复杂的 
structured	1.adj. 有结构的；有组织的 2.v. 组织；构成（structure的过去分词）；建造 
upgraded	1.v. 升级；改善（upgrade的过去分词） 2.adj. 提升的；更新的；加固的 
State-owned	1.adj. 国有的；国营的；州立的 
miracle	1.n. 奇迹，奇迹般的人或物；惊人的事例 2.n. (Miracle)人名；(英)米勒克尔；(意、西)米拉克莱 
lining	1.n. 衬里；内层；衬套 
dismay	1.n. 沮丧，灰心；惊慌 2.vt. 使沮丧；使惊慌 
purity	1.n. [化学] 纯度；纯洁；纯净；纯粹 2.n. (Purity)人名；(肯)普丽蒂 
peripheral	1.adj. 外围的；次要的；（神经）末梢区域的 2.n. 外部设备 
postal	1.n. 明信片 2.adj. 邮政的；邮局的 
instincts	1.n. [生物] 本能（instinct的复数）；[心理] 直觉 
rulings	1.adj. 统治的；主要的；支配的；流行的，普遍的 2.n. 统治，支配；裁定 
Convention	1.n. 大会；[法] 惯例；[计] 约定；[法] 协定；习俗 
blunt	1.adj. 钝的，不锋利的；生硬的；直率的 2.vt. 使迟钝 3.n. (Blunt)人名；(英)布伦特 
sink	1.n. 水槽；洗涤槽；污水坑 2.vi. 下沉；消沉；渗透 3.vt. 使下沉；挖掘；使低落 4.n. (Sink)人名；(英、瑞典)辛克 
edges	1.n. [地质] 边缘；边界；优势（edge的复数） 2.v. 挤进；侧身移动（edge的三单形式） 
servant	1.n. 仆人，佣人；公务员；雇工 2.n. (Servant)人名；(西)塞尔万特；(法)塞尔旺 
coherent	1.adj. 连贯的，一致的；明了的；清晰的；凝聚性的；互相偶合的；粘在一起的 
ignore	1.vt. 驳回诉讼；忽视；不理睬 
destined	1.v. 注定（destine的过去式和过去分词） 2.adj. 注定的；命定的；去往…的 
rebound	1.n. 回弹；篮板球 2.v. 重新装订（rebind的过去式和过去分词） 3.vt. 使弹回 4.vi. 回升；弹回 
canny	1.n. (Canny)人名；(英)坎尼 2.adj. 精明的，谨慎的；节约的 
maximise	1.vt. 把…增加到最大限度；尽量增大（等于maximize） 
disrupted	1.破坏 2.使瓦解 3.使分裂 4.使中断 5.使陷于混乱（disrupt的过去分词形式） 
crowdfunding	
contacts	1.n. 联系人；联络方式；触体；隐形眼镜（contact的复数形式） 2.v. 接触，联系（contact的第三人称单数形式） 
Bridge	1.n. 桥；桥牌；桥接器；船桥 2.vt. 架桥；渡过 3.n. (Bridge)人名；(英)布里奇 
exceptional	1.n. 超常的学生 2.adj. 异常的，例外的 
bumper	1.n. 缓冲器，保险杆，减震物 2.adj. 丰盛的，丰富的 3.vt. 装满；为…祝酒 4.vi. 干杯 
creeping	1.n. 爬行 2.v. 爬行；慢慢地移动（creep的现在分词） 3.adj. 爬行的；迟缓的；毛骨悚然的；奉承的 
Walter	1.n. 飞机应急雷达发射机 
Dodd-Frank	
ethnicity	1.n. 种族划分 
bailed	1.[法] 保释 2.帮助脱离困境（bail的过去式和过去分词） 
trimming	1.n. 整理；装饰品；配料；修剪下来的东西 
arise	1.vi. 出现；上升；起立 2.n. (Arise)人名；(西)阿里塞；(日)在濑(姓) 
rovers	1.n. 巡游者；海上掠夺 
Smaller	1.adj. 较小，更小的 
wore	1.v. 穿（衣服等）；戴（首饰等）；装着（wear的过去式） 
mantra	1.n. 咒语（尤指四吠陀经典内作为咒文或祷告唱念的）；颂歌 2.n. (Mantra)人名；(印尼)曼特拉 
middle-income	1.adj. 中等收入的 
admissions	1.n. 许可；承认；入会费；入场券（admission的复数形式） 
injury	1.n. 伤害，损害；受伤处 
havoc	1.n. 大破坏；浩劫；蹂躏 2.vt. 严重破坏 3.vi. 损毁 4.n. (Havoc)人名；(英)哈沃克 
modernising	1.vi. 现代化（等于modernize） 2.vt. 使…现代化（等于modernize） 
rubber	1.n. 橡胶；橡皮；合成橡胶；按摩师 2.adj. 橡胶制成的 3.vt. 涂橡胶于；用橡胶制造 4.vi. 扭转脖子看；好奇地引颈而望 5.n. (Rubber)人名；(西)鲁韦尔 
Budapest	1.n. 布达佩斯（匈牙利的首都） 
Brent	1.n. 黑雁 2.布伦特(英国英格兰东南部城市) 
louder	1.adv. 大声一点 
PSDB	
bloated	1.adj. 发胀的，浮肿的；傲慢的 2.v. 肿胀，得意（bloat的过去时形式） 
dogged	1.adj. 顽强的；顽固的 2.vt. 跟踪；尾随（dog的过去式） 
pretend	1.vt. 假装，伪装，模拟 2.adj. 假装的 3.vi. 假装，伪装，佯装 
comfortably	1.adv. 舒服地；安乐地；充裕地 
dismantle	1.vt. 拆除；取消；解散；除掉…的覆盖物 2.vi. 可拆卸 
nominate	1.vt. 推荐；提名；任命；指定 
wire	1.n. 电线；金属丝；电报 2.vt. 拍电报；给…装电线 3.vi. 打电报 4.n. (Wire)人名；(英)怀尔 
incompetence	1.n. 无资格，不胜任；无能力；不适当；不熟练 
Chuck	1.n. [机] 卡盘；抚弄；赶走；咯咯声；恰克（人名） 2.vt. 丢弃，抛掷；驱逐；轻拍 3.vi. 咯咯叫 
fuss	1.n. 大惊小怪，大惊小怪的人；小题大作；忙乱 2.vt. 使烦恼，使烦忧 3.vi. 小题大作；忙乱；焦燥；焦急；无事自扰 4.n. (Fuss)人名；(匈)富什；(法)菲斯 
denounce	1.vt. 谴责；告发；公然抨击；通告废除 
hypothesis	1.n. 假设 
reminiscent	1.n. 回忆录作者；回忆者 2.adj. 怀旧的，回忆往事的；耽于回想的 
rupees	1.n. 卢比（rupee复数） 
dared	1.v. 敢于（竟敢） 
translates	1.vt. 翻译；转化；解释；转变为；调动 2.vi. 翻译 
onerous	1.adj. 繁重的；麻烦的；负有义务的；负有法律责任的 
paramilitary	1.n. 准军事部队 2.adj. 准军事的；辅助军事的 
well-connected	1.adj. 有好亲戚的；出身名门的；血统关系好的；精心构思的 
Ibrahim	1.n. 易卜拉欣（与阿丹、努哈、穆萨、尔撒和穆罕默德并称为安拉的六大使者，亦系犹太教和基督教推崇的圣人和希伯来人的祖先） 
Cohen	1.科恩（姓氏） 
derided	1.vt. 嘲笑；嘲弄 
free-market	1.adj. free market的变形 
Fukushima	1.n. 福岛（日本城市） 
dispatch	1.n. 派遣；急件 2.vt. 派遣；分派 
spinning	1.n. 纺纱 2.v. 旋转，纺织（spin的现在分词） 3.adj. 纺织的 
insider	1.n. 内部的人，会员；熟悉内情者 
protects	1.保护 2.保险 
loathe	1.vt. 讨厌，厌恶 
uphold	1.vt. 支撑；鼓励；赞成；举起 
barometer	1.n. [气象] 气压计；睛雨表；显示变化的事物 
anticipation	1.n. 希望；预感；先发制人；预支 
stringent	1.adj. 严厉的；迫切的；银根紧的 
home-grown	1.adj. 在当地出产的；本国产的 
weekends	1.n. 周末（weekend的复数） 2.adv. 在每周末 
Connecticut	1.n. 美国康乃迪克州（位于美国东北部） 
grabbing	1.v. 抓；夺走；强烈吸引（grab的ing形式） 
unreliable	1.adj. 不可靠的；靠不住的 
upshot	1.n. 结果，结局；要点 
translate	1.vt. 翻译；转化；解释；转变为；调动 2.vi. 翻译 
Hawking	1.n. 利用鹰行猎 2.v. 袭击；翱翔；攫取（hawk的现在分词） 
blast	1.n. 爆炸；冲击波；一阵 2.vt. 爆炸；损害；使枯萎 3.vi. 猛攻 4.n. (Blast)人名；(德)布拉斯特 
organisms	1.n. [生物] 生物体（organism的复数）；[生物] 有机体 
magnitude	1.n. 大小；量级；[地震] 震级；重要；光度 
reassuring	1.v. 使放心（reassure的ing形式） 2.adj. 安心的；可靠的；鼓气的 
schoolchildren	1.n. 小学生（schoolchild的复数） 
spacecraft	1.n. [航] 宇宙飞船，航天器 
Nieto	1.n. (Nieto)人名；(意、西、葡)涅托 
long-awaited	1.adj. 被期待已久的 
surging	1.v. 冲击（surge的ing形式）；浪涌 
extortion	1.n. 勒索；敲诈；强夺；被勒索的财物 
Supporters	1.n. 支持者，支持单位；支持单元 
kidnapping	1.n. 绑架；诱拐 2.v. 绑架（kidnap的ing形式）；诱拐 
bypass	1.n. 旁路；[公路] 支路 2.vt. 绕开；忽视；设旁路；迂回 
Uganda	1.n. 乌干达（非洲国家） 
trap	1.n. 陷阱；圈套；[建] 存水弯 2.vt. 诱捕；使…受限制；使…陷入困境 3.vi. 设陷阱 4.n. (Trap)人名；(英)特拉普 
racism	1.n. 种族主义，种族歧视；人种偏见 
suspend	1.vt. 延缓，推迟；使暂停；使悬浮 2.vi. 悬浮；禁赛 
disagreement	1.n. 不一致；争论；意见不同 
Rhodes	1.n. 罗兹岛（希腊东南端佐泽卡尼索斯群岛中最大的岛屿）；罗兹市（罗兹岛上的港口城市） 
charitable	1.adj. 慈善事业的；慷慨的，仁慈的；宽恕的 
owe	1.vt. 欠；感激；应给予；应该把……归功于 2.vi. 欠钱 3.n. (Owe)人名；(瑞典、挪)奥弗 
probability	1.n. 可能性；机率；[数] 或然率 
incoming	1.n. 进入；到来；常作 incomings 收入，收益 2.adj. 进来的，到来的； 即将就任的 
upstart	1.n. 暴发户；自命不凡的人；傲慢自负的人 2.adj. 暴富的；自命不凡的 3.vt. 使…突然跳起；使…崛起 4.vi. 突然跳起；崛起 
indirectly	1.adv. 间接地；不诚实；迂回地 
deliberate	1.adj. 故意的；深思熟虑的；从容的 2.vt. 仔细考虑；商议 
intimidation	1.n. 恐吓，威胁 
blown	1.v. 风吹（blow的过去分词） 2.adj. 吹制的，吹出的；开花的，盛开的；喘气的 3.n. (Blown)人名；(英)布洛恩 
Keep	1.n. 保持；生计；生活费 2.vt. 保持；经营；遵守；饲养 3.vi. 保持；继续不断 4.n. (Keep)人名；(英)基普 
quicker	1.adj. 快些（quick的形容词比较级） 
longtime	1.adj. 长时间的；为时甚久的 2.adv. 长久地 
designing	1.n. 设计；阴谋 2.v. 计划；企图（design的现在分词） 3.adj. 有计划的；狡猾的 
delivers	1.交付 2.递送 
commissioners	1.委员 2.政府的特派员 3.地方长官（commissioner的名词复数） 
centralised	1.vt. 把…集中起来；形成中心 
rewarding	1.adj. 有益的，值得的；有报酬的，报答的 
meritocracy	1.n. 英才教育（制度）；精英管理的社会 
bitterly	1.adv. 苦涩地，悲痛地；残酷地；怨恨地 
peanuts	1.n. [作物] 花生；小人物；小零碎；微不足道的钱（peanut的复数形式） 
thrived	1.v. 兴盛，繁荣（thrive的过去式和过去分词形式） 
pharmaceuticals	1.n. 药物（pharmaceutical的复数） 
enrich	1.vt. 使充实；使肥沃；使富足 2.n. (Enrich)人名；(西)恩里奇 
Roger	1.n. 罗杰（男子名） 2.int. 好；知道了 
titans	1.n. 泰坦巨神；（美）大力神Ⅱ型洲际导弹（Titan的复数） 
Above	1.prep. 超过；在……上面；在……之上 2.n. 上文 3.adj. 上文的 4.adv. 在上面；在上文 
assassination	1.n. 暗杀，行刺 
venue	1.n. 审判地；犯罪地点；发生地点；集合地点 
curse	1.n. 诅咒；咒骂 2.vt. 诅咒；咒骂 3.vi. 诅咒；咒骂 
receipts	1.n. 企业、银行等）收到的款，进款；收到( receipt的名词复数 )；收入；收据；收条 
proceeding	1.n. 进行；程序；诉讼；事项 2.v. 开始；继续做；行进（proceed的ing形式） 
Pasok	1.泛希腊社会主义运动党 
diagnosis	1.n. 诊断 
Bristol	1.n. 布里斯托尔（英国西部的港口城市） 
cubicle	1.n. 小卧室；小隔间 
sunlight	1.n. 日光 2.n. (Sunlight)人名；(英)森莱特 
identifying	1.n. 识别，标识；标识关系 2.v. 识别（identify的现在分词） 
aluminium	1.n. 铝 2.adj. 铝的 
financiers	
ivory	1.n. 象牙；乳白色；长牙 2.adj. 乳白色的；象牙制的 3.n. (Ivory)人名；(英)艾沃里 
Albert	1.n. 艾伯特（男子名） 
miniature	1.n. 缩图；微型画；微型图画绘画术 2.adj. 微型的，小规模的 3.vt. 是…的缩影 
Depression	1.n. 沮丧；洼地；不景气；忧愁 
Gul	1.n. 古尔（姓氏）；图形界面编程 
Michel	1.n. 米歇尔（男子名） 
residency	1.n. 住处；住院医生实习期 
pioneering	1.adj. 首创的；先驱的 
unconstitutional	1.adj. 违反宪法的 2.违反宪法地 
Venezuelan	1.n. 委内瑞拉人 2.adj. 委内瑞拉的；委内瑞拉人的 
Kejriwal	
varied	1.v. 改变；使多样化（vary的过去式和过去分词形式） 2.adj. 多变的；各式各样的；杂色的 
influences	1.n. 影响，影响力；作用（influence的复数形式） 2.vt. 影响，感化（influence的三单形式） 
Speaking	1.n. 说话；演讲 2.v. 讲（speak的ing形式） 3.adj. 演讲的；富于表情的，雄辩的 
Mahmoud	1.穆罕默德（伊斯兰男名） 
barrier	1.n. 障碍物，屏障；界线 2.vt. 把…关入栅栏 3.n. (Barrier)人名；(法)巴里耶 
Renault	1.n. 雷诺（姓氏）；法国雷诺公司 
pretext	1.n. 借口；托辞 2.vt. 以…为借口 
pregnancies	1.n. 怀孕；丰富，多产；意义深长 
insects	1.n. [昆] 昆虫；昆虫类，昆虫纲（insect的复数形式） 
Taylor	1.n. 泰勒 
Nawaz	1.n. (Nawaz)人名；(印、孟、巴基、阿富)纳瓦兹 
upwards	1.adv. 向上；在上部；向上游 
tempting	1.v. 引诱（tempt的ing形式） 2.adj. 吸引人的；诱惑人的 
booze	1.n. 酒；酒宴 2.vi. 豪饮；痛饮 3.n. (Booze)人名；(英)布兹 
stay-at-home	1.n. 不爱出门的人；经常呆在家里的人 2.adj. 不爱出门的；经常呆在家里的 
Coalition	1.n. 联合；结合，合并 
Kabul	1.n. 喀布尔（阿富汗的首都） 
arranged	1.v. 安排；计划；准备（arrange的过去式和过去分词） 2.adj. 安排的 
shirts	1.n. [服装] 衬衫（shirt的复数形式） 
glacier	1.n. 冰河，冰川 
Businesses	1.[贸易] 商业 2.[贸易] 生意 3.[贸易] 交易 4.事情 （business的名词复数） 
revolutionaries	1.n. 革命分子（revolutionary的复数形式） 
congress	1.n. 国会；代表大会；会议；社交 
communists	1.n. 共产党员（communist的复数形式） 
measuring	1.n. 测量；衡量 2.v. 测量（measure的ing形式） 3.adj. 测量用的 
crammed	1.v. 填入；把…塞满；贪婪地吃；临时抱佛脚地死记硬背（cram的过去式） 2.adj. 挤满的；塞满的 
Compared	1.adj. 比较的，对照的（compare的过去式和过去分词） 
Treaty	1.n. 条约，协议；谈判 
bulls	1.n. 公牛队（美国篮球队名）；布尔斯（地名） 
retained	1.v. 保留；保存（retain的过去式形式） 2.adj. 保留的 
tilt	1.n. 倾斜 2.vt. 使倾斜；使翘起 3.vi. 倾斜；翘起；以言词或文字抨击 4.n. (Tilt)人名；(英)蒂尔特 
ceiling	1.n. 天花板；上限 
catastrophic	1.adj. 灾难的；悲惨的；灾难性的，毁灭性的 
composed	1.v. 组成；作曲（compose的过去分词）；著作 2.adj. 镇静的；沉着的 
publicity	1.n. 宣传，宣扬；公开；广告；注意 
saga	1.n. 传说；冒险故事；英雄事迹 2.n. (Saga)人名；(阿拉伯)萨贾；(芬、捷、瑞典)萨加 
drafted	1.v. 设计；挑选；拉开（draft的过去分词） 
classified	1.n. 分类广告 2.v. 把…分类（classify的过去分词） 3.adj. 分类的；类别的；机密的 
stronghold	1.n. 要塞；大本营；中心地 
prayer	1.n. 祈祷，祷告；恳求；祈祷文 
umbrella	1.n. 雨伞；保护伞；庇护；伞形结构 
majorities	1.n. 多数；成年 
benefiting	1.n. 利益，好处；救济金 2.vt. 有益于，对…有益 3.vi. 受益，得益 
accommodate	1.vi. 适应；调解 2.vt. 容纳；使适应；供应；调解 
worryingly	1.adv. 焦虑地；烦恼地 
affluent	1.n. 支流；富人 2.adj. 富裕的；丰富的；流畅的 
understands	1.vt. 理解；懂；获悉；推断；省略 2.vi. 理解；懂得；熟悉 
Luxembourg	1.n. 卢森堡（卢森堡公国首都）；卢森堡公国 
quantity	1.n. 量，数量；大量；总量 
rational	1.n. 有理数 2.adj. 合理的；理性的 
co-founder	1.n. 共同创立者 
cotton	1.n. 棉花；棉布；棉线 2.adj. 棉的；棉制的 3.vi. 一致；理解；和谐；亲近 4.n. (Cotton)人名；(英、西、葡)科顿；(法)戈登 
shaped	1.adj. 合适的；成某种形状的；有计划的 2.vt. 发展；成形（shape的过去分词和过去式） 
anonymous	1.adj. 匿名的，无名的；无个性特征的 
stripped	1.v. 剥夺（strip的过去分词形式）；脱衣；把…剪成条状 2.adj. 剥去的 
Philae	1.n. 菲莱（埃及岛屿） 
demonstrated	1.演示 
Kenyan	1.n. 肯尼亚人 2.adj. 肯尼亚的；肯尼亚人的 
adoption	1.n. 采用；收养；接受 
sessions	1.n. 会议；会期（session的复数） 
Elections	1.n. 选举，选举制；投票（election的复数形式） 
Belarus	1.n. 白俄罗斯，白俄罗斯共和国 
yoga	1.n. 瑜珈（意为“结合”，指修行）；瑜珈术；联想可360°翻转的平板电脑 
portrait	1.n. 肖像；描写；半身雕塑像 2.n. (Portrait)人名；(法)波特雷 
Silvio	1.西尔维奥 
champions	1.n. 冠军（champion的复数形式）；夺标；盟主 2.v. 拥护，保卫（champion的三单形式） 
exceeded	1.v. 超过（exceed的过去分词）；越出 2.adj. 非常的；过度的；溢出的 
acceptance	
NAFTA	1.abbr. 北美自由贸易协定（North American Free Trade Agreement） 2.n. (Nafta)人名；(罗)纳夫塔 
trickier	1.adj. 狡猾的；机警的 (tricky的变形) 
consumed	1.v. 消耗（consume的过去式和过去分词） 2.adj. 充满的；对…著迷的 
neutrality	1.n. 中立；中性；中立立场 
pipes	1.n. 管线，管道；[材] 管子（pipe复数形式） 2.v. 吹奏管乐；尖声叫嚷（pipe的第三人称单数形式） 3.n. (Pipes)人名；(英)派普斯 
enabling	1.v. 使能够；授权给（enable的现在分词） 2.adj. 授权的 
failings	1.n. 失败；缺点，过失；弱点 2.prep. 如果没有… 3.adj. 失败的 4.v. 失败；不及格（fail的ing形式） 5.n. (Failing)人名；(英)费林 
Investing	1.n. [机] 熔模铸造 2.v. 投资；授与（invest的现在分词） 
Suisse	1.n. （法）瑞士（等于Switzerland） 
civilisation	1.n. （英）文明（等于civilization） 
unpredictable	1.n. 不可预言的事 2.adj. 不可预知的；不定的；出乎意料的 
Kachin	1.n. 克钦（缅甸地名）；克钦人；克钦语 
creativity	1.n. 创造力；创造性 
forth	1.adv. 向前，向外；自…以后 2.n. (Forth)人名；(德)福特；(英)福思 
catch-up	1.n. 空白部分起脏；版面污染；急起直追 2.adj. 有助于赶上的 
photograph	1.n. 照片，相片 2.vt. 为…拍照；使深深印入 3.vi. 拍照；在照片上显得 
Hospital	1.n. 医院 2.n. (Hospital)人名；(英)霍斯皮特尔 
advertisements	1.n. [经] 广告（advertisement的复数）；宣传 
Nigerians	1.尼日利亚人 
client	1.n. [经] 客户；顾客；委托人 
Benjamin	1.n. 本杰明（男子名）；受宠爱的幼子 
Lego	1.n. 乐高积木（商标名） 
FIFA	1.n. 费法（已裂变原子数与初始装料易裂变原子数之比） 
bloodshed	1.n. 流血；杀戮 
textbooks	1.n. 教科书；课本（textbook的复数） 
Siemens	1.n. [电] 西门子（财富500强公司之一，总部所在地德国，主要经营电子电气） 
undocumented	1.adj. 无事实证明的；无正式文件的 
unmarried	1.adj. [法] 未婚的；单身的；独身的 2.v. 离婚（unmarry的过去分词） 
Lewis	1.n. 吊楔 
Cortés	
Somali	1.n. 索马里人；索马里语 2.adj. 索马里的 
Windows	1.n. 微软公司生产的“视窗”操作系统 
Golf	1.n. 高尔夫球；高尔夫球运动 2.vi. 打高尔夫球 3.n. (Golf)人名；(西、挪)戈尔夫 
pacifist	1.n. 和平主义者 2.adj. 非战主义的 
Bangkok	1.n. 曼谷（泰国首都） 
Migration	1.n. 迁移；移民；移动 
Hadi	1.n. (Hadi)人名；(阿拉伯、伊朗、土、印尼)哈迪 
influx	1.n. 流入；汇集；河流的汇集处 
Fidel	1.n. 卡斯特罗（男子名） 
internationally	1.adv. 国际性地；在国际间 
intensified	1.加强的 
Reforming	1.n. 重整；改进；变换（reform的ing形式） 
dotcom	1.n. 达康（公司名）；网站 
co-ordination	1.n. 协调；配合 
featured	1.v. 使…有特色；起重要作用（feature的过去分词） 2.adj. 特定的；被作为特色的；有…的面貌特征的 
plagued	1.v. 困扰（plague的过去分词）；折磨 
resilient	1.adj. 弹回的，有弹力的 
qualify	1.vi. 取得资格，有资格 2.vt. 限制；使具有资格；证明…合格 
catastrophe	1.n. 大灾难；大祸；惨败 
triple	1.n. 三倍数；三个一组 2.adj. 三倍的；三方的 3.vt. 使成三倍 4.vi. 增至三倍 
Munich	1.n. 慕尼黑（联邦德国城市） 
suppress	1.vt. 抑制；镇压；废止 
liberty	1.n. 自由；许可；冒失 2.n. (Liberty)人名；(英)利伯蒂 
fever	1.n. 发烧，发热；狂热 2.vt. 使发烧；使狂热；使患热病 3.vi. 发烧；狂热；患热病 
portion	1.n. 部分；一份；命运 2.vt. 分配；给…嫁妆 
bones	1.n. 骨骼；身体；争议点（bone的复数） 2.v. 剔去…的骨；专心致志（bone的第三人称单数） 3.n. (Bones)人名；(英)博恩斯；(德)博内斯 
contender	1.n. 竞争者；争夺者 
Interest	1.n. 兴趣，爱好；利息；趣味；同行 2.vt. 使……感兴趣；引起……的关心；使……参与 
imagined	1.v. 想象（imagine的过去分词）；猜测 2.adj. 想象的；构想的 
sheer	1.n. 偏航；透明薄织物 2.adj. 绝对的；透明的；峻峭的；纯粹的 3.vt. 使偏航；使急转向 4.adv. 完全；陡峭地 5.vi. 偏航 
abolish	1.vt. 废除，废止；取消，革除 
abolished	1.v. 彻底废除；摧毁（abolish的过去分词） 2.adj. 废除的 
uniform	1.n. 制服 2.adj. 统一的；一致的；相同的；均衡的；始终如一的 3.vt. 使穿制服；使成一样 
pact	1.n. 协定；公约；条约；契约 
hardline	1.adj. 强硬的；不妥协的 2.n. 强硬路线 
banning	1.n. 禁止；禁令 2.v. 禁止；取缔；限制（ban的ing形式） 3.adj. 禁止的 
retort	1.n. 反驳，顶嘴；曲颈瓶 2.vi. 反驳，回嘴 3.vt. 反驳，反击 
scrambling	1.n. 不规则性；加扰；混乱；攀登 2.v. 争夺；攀登；仓促地做；混杂（scramble的ing形式） 
mismanagement	1.n. 管理不善；处置失当 
trafficking	1.n. 非法交易（尤指毒品买卖） 2.vi. 交易（traffic的现在分词） 
bare	1.adj. 空的；赤裸的，无遮蔽的 2.vt. 露出，使赤裸 3.n. (Bare)人名；(英)贝尔 
announcing	1.v. 宣布；发表；通告（announce的ing形式） 
Ahmed	1.n. 艾哈迈德（男子名） 
framework	1.n. 框架，骨架；结构，构架 
al-Sisi	
Activists	1.n. 积极分子（activist的复数）；活动分子 
tapping	1.n. [冶] 出钢；开孔；出渣；轻敲声 2.v. 轻敲（tap的ing形式）；轻拍 3.n. (Tapping)人名；(英)塔平 
diversify	1.vt. 使多样化，使变化；增加产品种类以扩大 
buses	1.n. 公共汽车（bus的复数形式） 2.v. 乘公共汽车；用公共汽车运送（bus的第三人称单数形式） 
amounted	1.vi. 总计，合计；相当于；共计；产生…结果 2.n. 数量；总额，总数 
collectively	1.adv. 共同地，全体地 
competence	1.n. 能力，胜任；权限；作证能力；足以过舒适生活的收入 
apprenticeships	1.n. 学徒（apprenticeship的复数）；学徒制 
demise	1.n. 死亡，终止；转让；传位 2.vt. 遗赠；禅让 
prince	1.n. 王子，国君；亲王；贵族 2.n. (Prince)人名；(英、葡)普林斯；(法)普兰斯； 
fond	1.adj. 喜欢的；温柔的；宠爱的 2.n. (Fond)人名；(法)丰；(瑞典)丰德 
Reid	1.n. 里德（等于Read，男子名） 
portray	1.vt. 描绘；扮演 
cost-cutting	1.n. 削减成本 2.v. 削减成本（cost-cut的ing形式） 
pumped	1.v. 用泵送；汲取；使喘不过气来（pump的过去分词） 2.adj. （肌肉由于过度运动）肿胀的；喘得上气不接下气的；腐心的 
Bernstein	1.n. 伯恩斯坦（姓氏） 
highlights	1.n. 拔萃，集锦；挑染（highlight的复数形式） 2.v. 使突出（highlight的三单形式）；强调 
listing	1.n. 列表，清单 2.v. 列表（list的现在分词） 3.n. (Listing)人名；(德)利斯廷 
best-known	1.adj. 流传久远的，最有名的 
opted	1.选择 2.做出抉择（opt的过去式和过去分词） 
behavioural	1.adj. 行为的；动作的 
highway	1.n. 公路，大路；捷径 
breed	1.n. [生物] 品种；种类，类型 2.vt. 繁殖；饲养；养育，教育；引起 3.vi. 繁殖；饲养；产生 4.n. (Breed)人名；(英)布里德 
convert	1.n. 皈依者；改变宗教信仰者 2.vt. 使转变；转换…；使…改变信仰 3.vi. 转变，变换；皈依；改变信仰 4.n. (Convert)人名；(法)孔韦尔 
outer	1.n. 环外命中 2.adj. 外面的，外部的；远离中心的 
licensed	1.v. 许可；批准（license的过去分词） 2.adj. 得到许可的（等于licenced） 
whereby	1.adv. 凭借；通过…；借以；与…一致 
medium-sized	1.adj. 中型的，中等大小的；普通型的 
ingredients	1.材料；作料 
Dubai	1.n. 迪拜（阿拉伯联合酋长国的酋长国之一）；迪拜港（阿拉伯联合酋长国港市） 
Nevada	1.n. 内华达（美国州名） 
credit-card	
broker	1.n. 经纪人，掮客 2.vt. 以中间人等身分安排... 3.vi. 作为权力经纪人进行谈判 4.n. (Broker)人名；(英)布罗克；(俄)布罗克尔 
Anwar	1.n. 安瓦尔；艾乃哇尔（一部影片） 
distributed	1.adj. 分布式的，分散式的 
accessible	1.adj. 易接近的；可进入的；可理解的 
loth	1.n. (Loth)人名；(法、德、波)洛特；(英)洛思；(老)洛 2.adj. 不愿意的（等于loath）；勉强的；憎恶的 
comparable	1.adj. 可比较的；比得上的 
Snowden	1.n. 斯诺登（姓氏） 
Medicaid	1.n. （美）医疗补助计划 
Likud	1.n. 利库德集团（以色列右翼政党） 
Mubarak	1.n. 穆巴拉克（姓氏） 
reinforced	1.v. 加强；增援（reinforce的过去分词） 2.adj. 加固的；加强的；加筋的 
Buffett	1.n. 巴菲特（男子名） 
scare	1.n. 恐慌；惊吓；惊恐 2.vt. 惊吓；把…吓跑 3.adj. （美）骇人的 4.vi. 受惊 
methane	1.n. [有化] 甲烷；[能源] 沼气 
capitalisation	1.n. 市值（等于capitalization）；（英）资本化 
consolidation	1.n. 巩固；合并；团结 
ailing	1.adj. 生病的，身体不舒服的；体衰的 2.v. 生病；苦恼（ail的ing形式） 
eased	1.v. 放松（ease过去分词形式） 2.adj. 放松的 
understandable	1.adj. 可以理解的；可以了解的 
mighty	1.n. 有势力的人 2.adj. 有力的；强有力的；有势力的 3.adv. 很；极；非常 
devastating	1.adj. 毁灭性的；全然的 2.v. 摧毁（devastate的ing形式）；毁坏 
defaults	1.n. 违约；[计] 默认；预设值（default的复数） 2.v. 违约；[计] 默认（default的三单形式） 
shocks	1.n. [力] 冲击；震动；缓冲装置；蓬乱的一堆；禾束堆（shock的复数） 2.v. 使震动；使休克；感到震惊；把…堆成禾束堆（shock的三单形式） 
prefers	1.vt. 更喜欢；宁愿；提出；提升 2.vi. 喜欢；愿意 
frets	1.n. 琴格；焦躁；磨损处（fret的复数） 2.v. 烦躁；侵蚀（fret的第三人称单数） 
gloomy	1.adj. 黑暗的；沮丧的；阴郁的 
qualified	1.v. 限制（qualify的过去分词）；描述；授权予 2.adj. 合格的；有资格的 
mayors	1.市长 
delighted	1.adj. 高兴的；欣喜的 2.v. 使…兴高采烈；感到快乐（delight的过去分词） 
stark	1.adj. 完全的；荒凉的；刻板的；光秃秃的；朴实的 2.adv. 完全；明显地；突出地；质朴地 3.n. (Stark)人名；(俄、罗)斯塔尔克；(英、芬、法、瑞典)斯塔克；(德)施塔克 
tsunami	1.n. 海啸 
Cambodia	1.n. 柬埔寨（位于亚洲） 
steer	1.vt. 控制，引导；驾驶 2.vi. 驾驶，掌舵；行驶 3.n. 阉牛 4.n. (Steer)人名；(英)斯蒂尔；(德、匈)施特尔 
investigative	1.adj. 研究的；调查的；好调查的 
landslide	1.n. [地质] 山崩；大胜利 2.vi. 发生山崩；以压倒优胜获胜 
middle-aged	1.adj. 中年的；具有中年人特点的；适合于中年人的 
ranges	1.n. [仪] 量程，范围；[地理] 山脉（range的复数） 2.v. 延伸（range的第三人称单数）；排列；把…分类 
gambling	1.n. 赌博；投机 2.v. 赌博；打赌（gamble的ing形式） 3.n. (Gambling)人名；(英)甘布林 
liability	1.n. 责任；债务；倾向；可能性；不利因素 
simultaneously	1.adv. 同时地 
year-on-year	1.adj. 与上年同期数字相比的 
dwindling	1.减少 2.变小 3.退化 4.使减少（dwindle的现在分词） 
compulsory	1.n. （花样滑冰、竞技体操等的）规定动作 2.adj. 义务的；必修的；被强制的 
array	1.n. 数组，阵列；排列，列阵；大批，一系列；衣服 2.vt. 排列，部署；打扮 
happiness	1.n. 幸福 
approaching	1.v. 接近（approach的ing形式）；[航] 进场；侵入 
oversee	1.vt. 监督；审查；俯瞰；偷看到，无意中看到 
beneficiaries	1.n. [金融] 受益人（beneficiary的复数形式） 
posh	1.adj. 时髦地；漂亮的；奢侈的 
averages	1.n. 平均值；中等水平（average的复数形式） 2.v. 均分（average的三单形式）；算平均数；对…做出总的评价 
Down	1.prep. 沿着，往下 2.n. 软毛，绒毛；[地质] 开阔的高地 3.adj. 向下的 4.vt. 打倒，击败 5.adv. 向下，下去；在下面 6.vi. 下降；下去 7.n. (Down)人名；(英)唐 
ratios	1.n. 比率（ratio的复数）；比例 2.v. 以比率表示；按比例放大或缩小（ratio的第三人称单数） 
proliferation	1.n. 增殖，扩散；分芽繁殖 
devised	1.v. 设计（devise的过去式和过去分词）；计划；发明 
Water	1.n. 水；海水；雨水；海域，大片的水 2.vt. 使湿；供以水；给…浇水 3.vi. 加水；流泪 4.n. (Water)人名；(英)沃特 
spying	1.n. 间谍活动；侦探 2.v. 从事间谍活动；发现；仔细察看；暗中监视（spy的ing形式） 
guilt	1.n. 犯罪，过失；内疚 
scored	1.v. 在…上刻痕；牢记…的宿怨；得到…的分数（score的过去分词） 2.adj. 折叠的；刮伤的 
Faced	1.v. 面对（face的过去分词） 2.adj. 有某种面孔或表情的；有…表面的 
accountable	1.adj. 有责任的；有解释义务的；可解释的 
mid-terms	
lands	1.n. [农] 土地（land的复数形式）；平原；平面 2.v. 使登陆（land的第三人称单数形式） 3.n. (Lands)人名；(葡)兰茨 
fury	1.n. 狂怒；暴怒；激怒者 
decisive	1.adj. 决定性的；果断的，坚定的 
justices	1.n. 法官；司法；正义；公正（justice的复数） 
SWAT	1.n. 用劲打击；重拍；全垒打 2.vt. 重拍；猛击；用力击出（远距离球） 
stamp	1.n. 邮票；印记；标志；跺脚 2.vt. 铭记；标出；盖章于…；贴邮票于…；用脚踩踏 3.vi. 跺脚；捣碎；毁掉 4.n. (Stamp)人名；(德)施坦普；(英)斯坦普 
cleric	1.n. 牧师；传教士 2.adj. 牧师的，教士的 
execution	1.n. 执行，实行；完成；死刑 
Ethiopia	1.n. 埃塞俄比亚 
leftist	1.n. 左派；急进派；左翼的人；左撇子 2.adj. 左派的；左撇子的；急进派的 
motor	1.n. 发动机，马达；汽车 2.adj. 汽车的；机动的 3.vt. 以汽车载运 4.vi. 乘汽车 
counting	1.n. [数] 计算，计数 
dysfunctional	1.机能失调的,功能障碍的 
cargo	
chasing	1.n. [建] 雕镂术；车螺丝雕镂；铸件最后抛光 2.v. 追赶（chase的ing形式） 3.n. (Chasing)人名；(英)蔡辛 
Atlanta	1.n. 亚特兰大（美国城市） 
contributing	1.v. 捐献（contribute的ing形式） 2.adj. 贡献的；起作用的 
boycott	1.n. 联合抵制 2.vt. 联合抵制；拒绝参加 3.n. (Boycott)人名；(英)博伊科特 
evolutionary	1.adj. 进化的；发展的；渐进的 
communicate	1.vi. 通讯，传达；相通；交流；感染 2.vt. 传达；感染；显露 
UBS	1.abbr. 瑞士联合银行（United Bank of Switzerland） 
enabled	1.v. 使能够；授权给…（enable的过去分词） 2.adj. 激活的；可行的 
calculation	1.n. 计算；估计；计算的结果；深思熟虑 
considerably	1.adv. 相当地；非常地 
assessment	1.n. 评定；估价 
suspicions	1.n. 怀疑；嫌疑；疑心；一点儿 2.vt. 怀疑 
grace	1.n. 优雅；恩惠；魅力；慈悲 2.vt. 使优美 3.n. (Grace)人名；(英)格雷斯，格雷丝 (女名)；(法)格拉斯 
planners	1.n. 规划师；规划人员（planner的复数）；计划人员 
reflection	1.n. 反射；沉思；映象 
rubbish	1.n. 垃圾，废物；废话 2.adj. 毫无价值的 
Yasukuni	1.n. 靖国神社 
Sciences	1.n. 科学（science的复数） 
fraught	1.adj. 担心的，忧虑的；充满…的 
sticking	1.n. 粘辊；附着；坚持性 2.v. 粘住，坚持（stick的ing形式） 3.adj. 粘的；有粘性的 
quest	1.n. 追求；寻找 2.vt. 探索 3.vi. 追求；寻找 4.n. (Quest)人名；(德)奎斯特 
Howard	1.n. 霍华德（男子名） 
Williams	1.n. 威廉姆斯（男子名） 
favourable	1.n. 有利 2.adj. 有利的，顺利的；赞成的 
calculate	1.vt. 计算；预测；认为；打算 2.vi. 计算；以为；作打算 
tycoons	1.企业界大亨，巨头 2.巨富（tycoon的复数） 
component	1.n. 成分；组件；[电子] 元件 2.adj. 组成的，构成的 
counties	1.n. 郡，县 
Crime	1.n. 罪行，犯罪；罪恶；犯罪活动 2.vt. 控告……违反纪律 
resign	1.n. 辞去职务 2.vi. 辞职 3.vt. 辞职；放弃；委托；使听从 
strains	1.n. [微] 菌株（strain复数）；种族 2.v. [力] 拉紧；使过度劳累（strain的第三人称单数形式） 
knock	1.n. 敲；敲打；爆震声 2.vi. 敲；打；敲击 3.vt. 敲；打；敲击；批评 
modified	1.v. 修改；缓和（modify的过去分词） 2.adj. 改进的，修改的；改良的 
electrical	1.adj. 有关电的；电气科学的 
classical	1.n. 古典音乐 2.adj. 古典的；经典的；传统的；第一流的 
collecting	1.聚集 2.收集（collect的现在分词） 
oligarch	1.n. 寡头政治执政者 
remarks	1.n. 评论（remark的复数）；摘要；附注 
well-known	1.adj. 著名的；众所周知的；清楚明白的 
Coast	1.n. 海岸；滑坡 2.vt. 沿…岸航行 3.vi. 滑行；沿岸航行 4.n. (Coast)人名；(英)科斯特 
forecasters	1.n. 预报员 2.n. (Forecaster)人名；(英)福卡斯特 
Princeton	1.n. 普林斯顿（美国新泽西州中部的自治市镇） 
Pope	1.n. 教皇，罗马教皇；权威，大师 
Maliki	1.n. 伊斯兰教中马利基教派（强调获取穆斯林孩子抚养权的非穆斯林，不能给孩子伊斯兰所禁止的饮料和食物，如酒和猪肉） 
smog	1.n. 烟雾 
wiped	1.拭接 
install	1.vt. 安装；任命；安顿 
procedure	1.n. 程序，手续；步骤 
sacrifice	1.n. 牺牲；祭品；供奉 2.vt. 牺牲；献祭；亏本出售 3.vi. 献祭；奉献 
discover	1.vi. 发现 2.vt. 发现；发觉 
Gay	1.n. 同性恋者 2.adj. 快乐的；放荡的；艳丽的 3.n. (Gay)人名；(西)加伊；(英、法、瑞典、毛里塔)盖伊 
implemente	
addiction	1.n. 上瘾，沉溺；癖嗜 
capitalist	1.n. 资本家；资本主义者 2.adj. 资本主义的；资本家的 
Lehman	1.n. 雷曼（姓氏） 
fleeing	1.vt. 逃离（flee的ing形式） 2.vi. 突然消失（flee的ing形式） 
snapped	1.v. 啪啪作响；突然中断；猛咬；给…拍快照（snap的过去分词） 
personnel	
openness	1.n. 公开；宽阔；率真 
revolt	1.n. 反抗；叛乱；反感 2.vt. 使反感；使恶心 3.vi. 反抗；反叛；反感，厌恶 
tumbling	1.n. 翻筋斗；摔跤 2.adj. 歪斜状的 3.v. 跌倒；毁灭；被绊倒（tumble的ing形式） 
counterpart	1.n. 副本；配对物；极相似的人或物 
manufacturer	1.n. 制造商；[经] 厂商 
restoring	1.v. 恢复，重建；正在恢复（restore的现在分词） 2.adj. 恢复的 
resume	1.n. 摘要；[管理] 履历，简历 2.vi. 重新开始，继续 3.vt. 重新开始，继续；恢复，重新占用 
crushed	1.v. 压碎（crush的过去分词） 2.adj. 压碎的，倒碎的 
Cairo	1.n. 开罗（埃及首都） 
intact	1.adj. 完整的；原封不动的；未受损伤的 
divisive	1.adj. 分裂的；区分的；造成不和的 
unite	1.vi. 团结；联合；混合 2.vt. 使…混合；使…联合；使…团结 
Balkans	1.n. 巴尔干半岛各国；巴尔干半岛地区 
policemen	1.n. 警察（policeman的复数形式） 
embarrassing	1.adj. 使人尴尬的；令人为难的 
declares	1.vt. 宣布，声明；断言，宣称 2.vi. 声明，宣布 
dip	1.n. 下沉，下降；倾斜；浸渍，蘸湿 2.vi. 浸；下降，下沉；倾斜；舀，掏 3.vt. 浸，泡，蘸；舀取；把伸入 4.n. (Dip)人名；(尼)迪普 
deputies	1.n. 副手；二把手（deputy的复数形式） 
Lebanese	1.n. 黎巴嫩人 2.adj. 黎巴嫩的 
Salmond	1.n. (Salmond)人名；(英)萨蒙德 
guidelines	1.n. 指导方针 2.参考 
Lawrence	1.n. 劳伦斯（男子名） 
echo	1.n. 回音；效仿 2.vt. 反射；重复 3.vi. 随声附和；发出回声 
adopting	1.vt. 采取；接受；收养；正式通过 2.vi. 采取；过继 
riskier	1.冒险的（risky的比较级） 
formation	1.n. 形成；构造；编队 
inspiration	1.n. 灵感；鼓舞；吸气；妙计 
matched	1.v. 敌得过；和…相配（match的过去式和过去分词） 2.adj. 相配的；敌得过的 
subsidiaries	1.n. 子公司；下属公司（subsidiary的复数） 
achievements	1.n. 业绩；获得（achievement的复数） 
slows	1.n. [医] 乳毒病 2.v. 减速（slow的第三人称单数） 
challenger	1.n. 挑战者 2.n. (Challenger)人名；(英)查林杰 
comply	1.vi. 遵守；顺从，遵从；答应 
bargain	1.n. 交易；便宜货；契约 2.v. 讨价还价；议价；(谈价钱后)卖 
Trust	1.n. 信任，信赖；责任；托拉斯 2.vt. 信任，信赖；盼望；赊卖给 3.vi. 信任，信赖；依靠 4.n. (Trust)人名；(英)特拉斯特 
placing	1.n. 出售；铺设；得名次的人或物；私募资金 2.v. 放置（place的ing形式） 
identities	1.身份 2.特性 
haven	1.n. 港口；避难所，安息所 2.vt. 为……提供避难处；安置……于港中 3.n. (Haven)人名；(英)黑文 
speaker	1.n. 演讲者；扬声器；说话者；说某种语言的人 2.n. (Speaker)人名；(英)斯皮克 
pronounced	1.v. 发音；宣告；断言（pronounce的过去分词） 2.adj. 显著的；断然的；讲出来的 
mosque	1.n. 清真寺 
windows	1.n. 微软公司生产的“视窗”操作系统 
Amid	1.prep. 在其中，在其间 2.n. (Amid)人名；(法、阿拉伯)阿米德 
autocratic	1.adj. 专制的；独裁的，专横的 
eruption	1.n. 爆发，喷发；火山灰；出疹 
homeland	1.n. 祖国；故乡 
stomach	1.n. 胃；腹部；胃口 2.vt. 忍受；吃下 3.vi. 忍受 
Competition	1.n. 竞争；比赛，竞赛 
discounts	1.n. 优惠，折价；扣减额（discount的复数形式） 2.v. 打折扣（discount的三单形式）；[金融] 贴现；低估；漠视 
displayed	1.v. 表现（display的过去分词）；展示；陈列 2.adj. 显示的 
shame	1.n. 羞耻，羞愧；憾事，带来耻辱的人 2.vt. 使丢脸，使羞愧 3.n. (Shame)人名；(科特)沙梅 
Control	1.n. 控制；管理；抑制；操纵装置 2.vt. 控制；管理；抑制 
symptoms	1.n. [临床] 症状；症候；病徵 
smile	1.n. 微笑；笑容；喜色 2.vt. 微笑着表示 3.vi. 微笑 4.n. (Smile)人名；(塞)斯米莱 
intelligent	1.adj. 智能的；聪明的；理解力强的 
Radio	1.n. 收音机；无线电广播设备 2.vt. 用无线电发送 3.vi. 用无线电进行通信 4.n. (Radio)人名；(西)拉迪奥 
shocked	1.v. 使震动（shock的过去式） 2.adj. 震惊的；震撼的 
stateless	1.adj. 没有国家的；无国家主权的 
sufficiently	1.adv. 充分地；足够地 
noise	1.n. [环境] 噪音；响声；杂音 2.vt. 谣传 3.vi. 发出声音；大声议论 4.n. (Noise)人名；(英)诺伊斯 
essence	1.n. 本质，实质；精华；香精 2.n. (Essence)人名；(英)埃森丝 
tournament	1.n. 锦标赛，联赛；比赛 
notoriously	1.adv. 众所周知地；声名狼藉地；恶名昭彰地 
Quebec	1.n. 魁北克（加拿大港市省名） 
Care	1.n. 关怀；照料；谨慎；忧虑 2.vt. 在意；希望或喜欢 3.vi. 照顾；关心；喜爱；顾虑 4.n. (Care)人名；(英)凯尔；(塞)察蕾 
implies	1.v. 意味着（imply的第三人称单数）；蕴含；暗指 
Senior	1.n. 上司；较年长者；毕业班学生 2.adj. 高级的；年长的；地位较高的；年资较深的，资格较老的 3.n. (Senior)人名；(英)西尼尔 
outspoken	1.adj. 坦率的，直言不讳的 
unionists	1.n. 工会会员；联合主义者 
hosting	1.n. 作战；群众或部队的集合 
portfolios	1.n. 档案；文件夹（portfolio的复数）；证券投资组合 
Romanians	1.n. 罗马尼亚人；罗马尼亚语 2.adj. 罗马尼亚的 
Researchers	1.n. 研究人员，研究者（researcher的复数形式） 
mysterious	1.adj. 神秘的；不可思议的；难解的 
wondered	1.奇迹 2.想知道 
Android	1.n. 机器人；安卓操作系统 
ruthless	1.adj. 无情的，残忍的 
costing	1.n. 成本计算；生产费用 2.v. 花费（cost的ing形式） 3.n. (Costing)人名；(罗)科斯廷格 
defending	1.v. 防护；防卫（defend的ing形式） 2.adj. 卫冕的；防御中的；防守型的 
Harris	1.n. 哈里斯（英国苏格兰一地区）；哈里斯（姓氏） 
ancestors	1.n. [生物] 祖先，上代；先祖（ancestor复数形式） 
glance	1.n. 一瞥；一滑；闪光 2.vt. 扫视；瞥见；擦过 3.vi. 扫视，匆匆一看；反光；瞥闪，瞥见 4.n. (Glance)人名；(英)格兰斯 
wasted	1.v. 浪费（waste的过去式） 2.adj. 浪费的 
debating	1.v. 辩论（debate的ing形式） 
virtues	1.n. 优点，贞操；美德 
widening	1.v. 使扩大；拓宽；扩展（widen的ing形式）；使变宽 
toppled	1.vi. 倾倒；倒塌；摇摇欲坠 2.vt. 推翻；颠覆；使倒塌 3.n. (Topple)人名；(英)托佩尔 
earns	1.vt. 赚，赚得；获得，挣得；使得到；博得 2.n. (Earn)人名；(泰)炎 
Premier	1.n. 总理，首相 2.adj. 第一的；最初的 
sperm	1.n. 精子；精液；鲸蜡油 
healthier	1.adj. 更健康（healthy的比较级） 
concedes	1.vt. 承认；退让；给予，容许 2.vi. 让步 
surgery	1.n. 外科；外科手术；手术室；诊疗室 
Geithner	1.n. 盖纳（姓氏） 
Yerkes	1.n. 耶基斯（姓氏） 
Trans-Pacific	
journalism	1.n. 新闻业，新闻工作；报章杂志 
architecture	1.n. 建筑学；建筑风格；建筑式样 
secession	1.n. 脱离；分离 
recipe	1.n. 食谱；[临床] 处方；秘诀 
parenting	1.n. 父母对子女的养育 2.v. 教养（parent的ing形式）；做…的父亲或母亲 
slight	1.n. 怠慢；轻蔑 2.adj. 轻微的，少量的；脆弱的；细长的；不重要的 3.vt. 轻视，忽略；怠慢 
twist	1.n. 扭曲；拧；扭伤 2.vt. 捻；拧；扭伤；编织；使苦恼 3.vi. 扭动；弯曲 4.n. (Twist)人名；(英)特威斯特 
indebted	1.adj. 负债的；感激的；受惠的 2.v. 使负债；使受恩惠（indebt的过去分词） 
absorbed	1.v. 吸收；使全神贯注（absorb的过去分词形式） 2.adj. 被吸收的；一心一意的 
obsession	1.n. 痴迷；困扰；[内科][心理] 强迫观念 
mentally	1.adv. 精神上，智力上；心理上 
pilots	1.n. [航] 飞行员；向导；试播节目；自动驾驶仪（pilot的复数） 2.v. 领航；指引；试用（pilot的三单形式） 
dismiss	1.vt. 解散；解雇；开除；让...离开；不予理会、不予考虑 2.vi. 解散 
advocacy	1.n. 主张；拥护；辩护 
endorse	1.vt. 背书；认可；签署；赞同；在背面签名 
fashionable	1.adj. 流行的；时髦的；上流社会的 
substitute	1.n. 代用品；代替者 2.vi. 替代 3.vt. 代替 
subjected	1.v. 使遭受（subject的过去分词形式）；使从属；受…影响 
charts	1.n. 图表；排行榜（chart的复数） 2.v. 绘制…的海图；制订计划（chart的第三人称单数） 
cocaine	1.n. [药] 可卡因 
killings	1.n. 杀戮（killing的复数） 
money-laundering	1.洗钱 
beach	1.n. 海滩；湖滨 2.vt. 将…拖上岸 3.vi. 搁浅；定居 4.n. (Beach)人名；(英)比奇 
outskirts	1.n. 市郊，郊区 
receives	1.n. 受光面 2.v. 接受，接收（receive的第三人称单数） 
interviews	1.n. 访谈；面试；面谈（interview的复数） 2.v. 面试（interview的三单形式）；接见 
slaves	1.n. 奴隶, 服伺的人; 侍女; 上瘾; 服务于另一连接计算机的系统 (计算机用语) 
designer	1.n. 设计师；谋划者 2.adj. 由设计师专门设计的；享有盛名的；赶时髦的 
poised	1.adj. 泰然自若的，镇定的；平衡的，均衡的；摆好姿势不动的，静止的 
faction	1.n. 派别；内讧；小集团；纪实小说 
sorry	1.adj. 遗憾的；对不起的，抱歉的 2.int. 对不起，抱歉（表示委婉的拒绝等） 
blocking	1.n. 阻塞；封闭；大块 2.v. 阻塞（block的ing形式） 
Saleh	1.n. 萨利赫（人名） 
illicit	1.adj. 违法的；不正当的 
indefinitely	1.adv. 不确定地，无限期地；模糊地，不明确地 
celebration	1.n. 庆典，庆祝会；庆祝；颂扬 
shield	1.n. 盾；防护物；保护者 2.vt. 遮蔽；包庇；避开；保卫 3.vi. 防御；起保护作用 4.n. (Shield)人名；(英)希尔德 
overthrow	1.n. 推翻；倾覆；瓦解 2.vt. 推翻；打倒；倾覆 
insights	1.n. 洞察力；眼力；深刻见解（insight的复数） 
schooling	1.n. 学校教育；学费 2.v. 教育（school的ing形式）；培养 3.n. (Schooling)人名；(英)斯库林 
symbolic	1.adj. 象征的；符号的；使用符号的 
prospective	1.n. 预期；展望 2.adj. 未来的；预期的 
preserving	1.n. 保留，保存 
slip	1.n. 滑，滑倒；片，纸片；错误；下跌；事故 2.abbr. 串行线路接口协议，是旧式的协议（Serial Line Interface Protocol） 3.adj. 滑动的；有活结的；活络的 4.vt. 使滑动；滑过；摆脱；塞入；闪开 5.vi. 滑动；滑倒；犯错；失足；减退 6.n. (Slip)人名；(芬)斯利普 
gear	1.n. 齿轮；装置，工具；传动装置 2.adj. 好极了 3.vt. 开动；搭上齿轮；使……适合；使……准备好 4.vi. 适合；搭上齿轮；开始工作 5.n. (Gear)人名；(英)吉尔 
Dominican	1.n. 多明尼加共和国的居民 2.adj. 多明尼加共和国的 
conversion	1.n. 转换；变换；[金融] 兑换；改变信仰 
venture-capital	1.风险资本 
specialised	1.adj. 专门的；特别的（等于specialized） 2.v. 使专门化；专攻；详细说明（specialise的过去分词） 
briefing	1.n. 简报；作战指示 2.v. 概述；作…的摘要（brief的现在分词） 
gadgets	1.n. 小配件；小工具（gadget的复数） 
gloom	1.n. 忧郁；阴暗 2.vt. 使黑暗；使忧郁 3.vi. 变阴暗；变忧沉；感到沮丧 
brutality	1.n. 无情；残忍；暴行（需用复数形式） 
teenager	1.n. 十几岁的青少年；十三岁到十九岁的少年 
depreciation	1.n. 折旧；贬值 
Maria	1.n. 母驴；母马 2.【天文学】海(指月亮、火星表面的阴暗部分) 
McConnell	1.麦康内尔（美国地名） 2.n. (McConnell)人名；(英)麦康奈尔 
agreeing	1.v. 同意（agree的ing形式） 
Congressional	1.adj. 国会的；会议的；议会的 
conservatism	1.n. 保守主义；守旧性 
farmer	1.n. 农夫，农民 2.n. (Farmer)人名；(英)法默；(法)法尔梅；(西)法梅尔 
Boeing	1.n. 波音（客机） 
prisons	1.n. 监狱；监禁；拘留所 2.vt. 监禁，关押 3.n. (Prison)人名；(德)普里松 
privilege	1.n. 特权；优待；基本权利 2.vt. 给与…特权；特免 
elusive	1.adj. 难懂的；易忘的；逃避的；难捉摸的 
assumes	1.假定 2.假设 
south-western	1.adj. 西南的；位于西南方的 
inland	1.n. 内地；内陆 2.adj. 内陆的；内地的；国内的 3.adv. 在内地；向内地；向内陆；在内陆 
kidnapped	1.v. 诱拐，绑架（kidnap过去时形式） 
descendant	1.n. 后裔；子孙 2.adj. 下降的；祖传的 
endure	1.vt. 忍耐；容忍 2.vi. 忍耐；持续 
container	1.n. 集装箱；容器 
rivalry	1.n. 竞争；对抗；竞赛 
Alan	1.n. 艾伦（男子名） 
secretary-general	1.n. 秘书长；总书记 
taxis	1.n. 整腹法；反射运动；分类法；（古希腊军队的）分队；排列 2.n. (Taxis)人名；(英、芬)塔克西斯 
implied	1.adj. 含蓄的；暗指的 2.vt. 暗示；意味（imply的过去式） 
funeral	1.n. 葬礼；麻烦事 2.adj. 丧葬的，出殡的 
Mumbai	1.n. 孟买（印度城市） 
merit	1.n. 优点，价值；功绩；功过 2.vt. 值得 3.vi. 应受报答 
located	1.adj. 处于，位于；坐落的 
entrenched	1.v. 确立；保证；挖掘壕沟（entrench的过去分词） 2.adj. 根深蒂固的；确立的，不容易改的 
chaotic	1.adj. 混沌的；混乱的，无秩序的 
consistent	1.adj. 始终如一的，一致的；坚持的 
versus	1.prep. 对；与...相对；对抗 
innovations	1.n. 创新（innovation的复数）；改革 
scant	1.adj. 不足的；缺乏的；勉强够的 2.vt. 减少；节省；限制 
Affairs	1.n. 事务，事宜；风流韵事 
conquest	1.n. 征服，战胜；战利品 2.n. (Conquest)人名；(英)康奎斯特 
define	1.vt. 定义；使明确；规定 2.n. (Define)人名；(英)德法恩；(葡)德菲内 
pursued	1.v. 追击，追踪；继续从事（pursue的过去分词形式） 
bargaining	1.n. 讨价还价；交易；交涉 2.v. 讨价还价；交易（bargain的ing形式） 
Opinion	1.n. 意见；主张 
dialogue	1.n. 对话；意见交换 2.vt. 用对话表达 3.vi. 对话 
Gulen	
Hamlets	1.小村 
inspire	1.vt. 激发；鼓舞；启示；产生；使生灵感 
condoms	1.n. [医] 避孕套；橡皮套（condom复数形式） 
exaggerate	1.vt. 使扩大；使增大 2.vi. 夸大；夸张 
oceans	1.n. [海洋] 海洋（ocean的复数形式） 
staging	1.n. 上演；分段运输；脚手架；乘驿马车的旅行 2.v. 表演；展现；分阶段进行；筹划（stage的ing形式） 
averaged	1.v. 平均（average的过去式） 2.adj. 平均的 
intriguing	1.adj. 有趣的；迷人的 2.v. 引起…的兴趣；策划阴谋；私通（intrigue的ing形式） 
stretched	1.v. 伸直，伸展；舒展（stretch的过去分词）；伸缩 2.adj. 拉伸的，伸展了的 
Caracas	1.n. 加拉加斯（委内瑞拉首都） 
subscription	1.n. 捐献；订阅；订金；签署 
accepting	1.v. 接受；同意；承担（责任等）（accept的ing形式） 2.adj. 承兑的；易接受的；赞同的 
disorder	1.n. 混乱；骚乱 2.vt. 使失调；扰乱 
coal-fired	1.adj. 烧煤的 
assert	1.vt. 维护，坚持；断言；主张；声称 
generic	1.adj. 类的；一般的；属的；非商标的 
disabled	1.adj. 残废的，有缺陷的 2.v. 使…失去能力（disable的过去分词） 
strategists	1.n. 战略家；军事家 
Armenians	1.n. 亚美尼亚人（Armenian的复数） 
slaughter	1.n. 屠宰，屠杀；杀戮；消灭 2.vt. 屠宰，屠杀；杀戮；使惨败 3.n. (Slaughter)人名；(英)斯劳特 
Baltic	1.n. 波罗的海 2.adj. 波罗的海的 
dressed	1.v. 装饰；给…穿衣；布置（dress的过去分词） 2.adj. 穿好衣服的；打扮好的；去内脏及分割加工好的（特指动物，如鱼，禽类等） 
myriad	1.n. 无数，极大数量；无数的人或物 2.adj. 无数的；种种的 
motion	1.n. 动作；移动；手势；请求；意向 2.vt. 运动；向…打手势 3.vi. 运动；打手势 
profitability	1.n. 赢利能力；收益性；利益率 
acceptable	1.adj. 可接受的；合意的；可忍受的 
monitors	1.n. [自] 监视器，监控器；情况通报（monitor复数形式） 
franchise	1.n. 特权；公民权；经销权；管辖权 2.vt. 给…以特许（或特权）；赋予公民权 
Liberals	1.n. 自由主义者（liberal的复数） 
equals	1.n. 对手；（地位、实力等）相同或相等的人；相等物（equal的复数形式） 2.v. 平等（equal的第三人称单数形式）；与…相同 
mayhem	1.n. 故意的伤害罪；重伤罪；蓄意的破坏 
reef	1.n. 暗礁；[地质] 矿脉；收帆 2.vt. 收帆；缩帆 3.vi. 缩帆；收帆 
miners	1.n. [矿业] 矿工（miner的复数）；煤矿工人 2.n. (Miners)人名；(英)迈纳斯 
Oregon	1.n. 俄勒冈州（美国州名） 
entrepreneurial	1.adj. 企业家的，创业者的；中间商的 
application	1.n. 应用；申请；应用程序；敷用 
maternity	1.n. 母性，母道；[妇产] 妇产科医院 2.adj. 产科的；产妇的，孕妇的 
ideals	1.n. [数] 理想（ideal的复数） 
Miami	1.n. 迈阿密（美国美国佛罗里达州东南部港市） 
Barbara	1.n. 芭芭拉（女子名） 
custody	1.n. 保管；监护；拘留；抚养权 
Toyota	1.n. 日本丰田汽车（公司名） 
piled	1.v. 堆积；积累（pile的过去分词） 2.adj. 有细毛的 
whopping	1.adj. 巨大的；天大的 2.adv. 非常地；异常地 3.v. 猛打；抽出（whop的ing形式） 
Nixon	1.n. 尼克松（美国第37任总统） 
accommodation	1.n. 住处，膳宿；调节；和解；预订铺位 
headache	1.n. 头痛；麻烦；令人头痛之事 
Alberto	1.n. 阿尔贝托（阿塞拜疆教练） 
operated	1.v. 操作（operate的过去式和过去分词） 2.adj. 操作的 
seizing	1.n. 抓；夺；捆绑 2.v. 抓住；利用（seize的ing形式）；理解 
halved	1.v. 对半分开；均分；把…减半（halve的过去式和过去分词） 
reporters	1.n. 记者（reporter的复数） 
flash	1.n. 闪光，闪现；一瞬间 2.adj. 闪光的，火速的 3.vt. 使闪光；反射 4.vi. 闪光，闪现；反射 5.n. (Flash)人名；(西)弗拉什 
harvest	1.n. 收获；产量；结果 2.vt. 收割；得到 3.vi. 收割庄稼 
tracked	1.v. [计][电子] 跟踪，追踪（track的过去式） 2.adj. 有履带的 
offenders	1.n. 罪犯（offender的复数）；冒犯者 
equipped	1.v. 装备；预备（equip的过去分词）；整装 
Hussein	1.n. 侯赛因（姓氏） 
corporations	1.n. [贸易] 公司，[经] 企业（corporation的复数形式） 
Morocco	1.n. 摩洛哥（非洲一国家名）；[皮革] 摩洛哥皮革 
opera	1.n. 歌剧；歌剧院；歌剧团 2.n. (Opera)人名；(意)奥佩拉 
Portuguese	1.n. 葡萄牙人；葡萄牙语 2.adj. 葡萄牙的；葡萄牙人的；葡萄牙语的 
Minsk	1.n. 明斯克（白俄罗斯首都） 
depressing	1.adj. 压抑的；使人沮丧的 
monarchy	1.n. 君主政体；君主国；君主政治 
liberalism	1.n. 自由主义；开明的思想或见解 
tolerate	1.vt. 忍受；默许；宽恕 
Patrick	1.n. 帕特里克（男子名） 
squad	1.n. 班；小队；五人组（篮球队的非正式说法） 2.vt. 把…编成班；把…编入班 
avert	1.vt. 避免，防止；转移 
unintended	1.adj. 无意识的；非计划中的 
oversees	1.监视 
wells	1.n. 威尔斯（姓氏） 
adjustment	1.n. 调整，调节；调节器 
accumulated	1.v. 累积（accumulate的过去分词） 2.adj. 累积的；累计的；达到 
heroes	1.n. 英雄（hero的复数形式） 
demonstrates	1.示范 2.论证 
Partners	1.n. 伙伴（partner的复数形式）；合作伙伴；[法] 合伙人 2.v. 合伙；成为搭档（partner的第三人称单数） 
creatures	1.n. 生物（creature的复数） 
repaid	1.v. 偿还；报答（repay的过去分词） 2.adj. 偿付的 
doubling	1.n. 加倍；并线；折回；防护板；衬里 2.v. 使加倍；使成双（double的ing形式）；绕过；握紧 3.adj. 双重的；折叠的 
hybrid	1.n. 杂种，混血儿；混合物 2.adj. 混合的；杂种的 
hiding	1.n. 隐匿；躲藏处；殴打 2.n. (Hiding)人名；(瑞典)希丁 
Monitor	1.n. 监视器；监听器；监控器；显示屏；班长 2.vt. 监控 
travels	1.n. 旅途；旅行笔记 2.v. 旅行（travel的第三人称单数形式） 
stroke	1.n. （游泳或划船的）划；中风；（打、击等的）一下；冲程；（成功的）举动；尝试；轻抚 2.vt. （用笔等）画；轻抚；轻挪；敲击；划尾桨；划掉；（打字时）击打键盘 3.vi. 击球；作尾桨手，指挥划桨；（打字时）击打键盘 
experimental	1.adj. 实验的；根据实验的；试验性的 
imagination	1.n. [心理] 想象力；空想；幻想物 
personally	1.adv. 亲自地；当面；个别地；就自己而言 
Koreans	1.n. 韩国人（Korean的复数形式）；朝鲜人 
plunging	1.n. 倒转 2.v. （使）投入，（使）插入；急降；从事（plunge的ing形式） 3.adj. 跳进的；突进往下的 
consecutive	1.adj. 连贯的；连续不断的 
subscribers	1.n. 订阅者，[金融] 认股人；捐款人（subscriber复数形式） 
mentor	1.n. 指导者，良师益友 2.vt. 指导 
nerve	1.n. 神经；勇气；[植] 叶脉 2.vt. 鼓起勇气 
innocent	1.n. 天真的人；笨蛋 2.adj. 无辜的；无罪的；无知的 3.n. (Innocent)人名；(英、西)因诺森特；(法)伊诺桑 
reluctance	1.n. [电磁] 磁阻；勉强；不情愿 
influenced	1.v. 影响（influence的过去分词） 2.adj. 受影响的 
trim	1.n. 修剪；整齐；情形 2.vt. 修剪；整理；装点 3.adj. 整齐的 4.vi. 削减 5.n. (Trim)人名；(意)特里姆 
assumptions	1.n. 假定，设想（assumption复数形式） 
beside	1.prep. 在旁边；与…相比；和…无关 
lawsuit	1.n. 诉讼（尤指非刑事案件）；诉讼案件 
fulfil	1.vt. 履行；完成；实践；满足 
one-fifth	
bullets	1.n. [军] 子弹（bullet的复数形式） 
pro-democracy	1.支持民主 
footage	1.n. 英尺长度；连续镜头；以尺计算长度 
strangely	1.adv. 奇怪地；奇妙地；不可思议地 
Force	1.n. 力量；武力；军队；魄力 2.vt. 促使，推动；强迫；强加 3.n. (Force)人名；(意)福尔切；(英、法)福斯 
Arabic	1.n. 阿拉伯语 2.adj. 阿拉伯的；阿拉伯人的 
erosion	1.n. 侵蚀，腐蚀 
adequate	1.adj. 充足的；适当的；胜任的 
Glasgow	1.n. 格拉斯哥（英国城市名） 
informed	1.v. 通知；使了解；提供资料（inform的过去分词） 2.adj. 消息灵通的；见多识广的 
dairy	1.n. 奶制品；乳牛；制酪场；乳品店；牛奶及乳品业 2.adj. 乳品的；牛奶的；牛奶制的；产乳的 
world-class	1.n. 世界级 2.adj. 世界级的 
independently	1.adv. 独立地；自立地 
analysed	1.v. 分析（analyse的过去分词） 
alien	1.n. 外国人，外侨；外星人 2.adj. 外国的；相异的，性质不同的；不相容的 3.vt. 让渡，转让 4.n. (Alien)人名；(法)阿利安 
clearer	1.n. [助剂] 澄清剂；清洁器 2.adj. 更清楚的 
determination	1.n. 决心；果断 
residence	1.n. 住宅，住处；居住 
column	1.n. 纵队，列；专栏；圆柱，柱形物 
sizeable	1.adj. 大的，相当大的 
nominated	1.v. 提名；任命（nominate的过去分词） 2.adj. 被提名的；被任命的 
motivation	1.n. 动机；积极性；推动 
Berkeley	1.n. 贝克莱（爱尔兰主教及哲学家）；伯克利（姓氏）；伯克利（美国港市） 
geography	1.n. 地理；地形 
encounter	1.n. 遭遇，偶然碰见 2.vi. 遭遇；偶然相遇 3.vt. 遭遇，邂逅；遇到 
ample	1.adj. 丰富的；足够的；宽敞的 2.n. (Ample)人名；(西)安普尔 
interpretation	1.n. 解释；翻译；演出 
Morsi	1.莫尔西（地名） 
arrests	1.n. [法] 拘留（arrest的复数）；停止点；临界点 2.v. [法] 逮捕；阻止（arrest的单三形式） 
Real	1.n. 现实；实数 2.adj. 实际的；真实的；实在的 3.adv. 真正地；确实地 4.n. (Real)人名；(德、西、葡、法)雷亚尔；(英)里尔 
Kremlin	1.n. 克里姆林宫（前苏联政府） 2.adj. 克里姆林宫的；前苏联政府的 
rooted	1.v. 生根（root的过去式） 2.adj. 根深蒂固的；生根的 
Hundreds	1.n. 数百 2.百 3.百分之百 4.成百上千 
Kuan	1.n. 官窑瓷器 2.n. (Kuan)人名；(俄)库安 
IPO	1.abbr. 首次公开募股（Initial Public Offerings）；初次公开发行（Initial Public Offering） 
pleasure	1.n. 快乐；希望；娱乐；令人高兴的事 2.vt. 使高兴；使满意 3.vi. 高兴；寻欢作乐 
spotted	1.v. 发现（spot的过去分词）；玷污；弄上污痕 2.adj. 有斑点的；斑纹的；弄污的 3.n. (Spotted)人名；(英)斯波蒂德 
sovereign-wealth	
overwhelmingly	1.adv. 压倒性地；不可抵抗地 
Adam	1.n. 亚当 
Rajapaksa	
highlight	1.n. 最精彩的部分；最重要的事情；加亮区 2.vt. 突出；强调；使显著；加亮 
Securities	1.n. [金融] 有价证券；担保；抵押物（security的复数）；保证人 
MH17	
warrant	1.n. 根据；证明；正当理由；委任状 2.vt. 保证；担保；批准；辩解 
incident	1.n. 事件，事变；插曲 2.adj. [光] 入射的；附带的；易发生的，伴随而来的 
Bennett	1.n. 班尼特（男子名，等于Benedict） 
walking	1.n. 步行；散步 2.v. 步行（walk的ing形式） 3.adj. 步行的 
Abenomics	
implementation	1.n. [计] 实现；履行；安装启用 
tightly	1.adv. 紧紧地；坚固地 
tongue	1.n. 舌头；语言 2.vt. 舔；斥责；用舌吹 3.vi. 说话；吹管乐器 4.n. (Tongue)人名；(英)唐 
remembered	1.vt. 记得；牢记；纪念；代…问好 2.vi. 记得，记起 
Cameroon	1.n. 喀麦隆（西非国名） 
Estonia	1.n. 爱沙尼亚 
Spaniards	1.西班牙人 
cannabis	1.n. 印度大麻（等于hemp）；大麻烟原料；大麻雌花顶部 
double-digit	1.adj. 两位数的 
constituents	1.n. 成分（constituent的复数） 
acid	1.n. 酸；<俚>迷幻药 2.adj. 酸的；讽刺的；刻薄的 
longest	1.adj. 最长的 2.n. (Longest)人名；(英)朗格斯特 
debut	1.n. 初次登台；开张 2.vi. 初次登台 3.n. (Debut)人名；(法)德比 
grassroots	1.n. 草根；基础 2.adj. 基层的；草根的；乡村的 
Icahn	1.伊坎(人名) 
parade	1.n. 游行；阅兵；炫耀；行进；阅兵场 2.vt. 游行；炫耀；列队行进 3.vi. 游行；炫耀；列队行进 4.n. (Parade)人名；(法、德)帕拉德 
wonderful	1.adj. 极好的，精彩的，绝妙的；奇妙的；美妙；胜；神妙 
owning	1.有 
holders	1.n. [专利] 持有人（holder的复数） 
aspirations	1.n. 愿望 
aiming	1.n. 目标；瞄准；导航，引导 2.v. 针对；瞄准；旨在（aim的ing形式）；力求 
Oliver	1.n. 奥利弗（男子名） 
persist	1.vi. 存留，坚持；持续，固执 2.vt. 坚持说，反复说 
rescued	1.救援 
Nordic	1.n. 北欧人；日耳曼民族；斯堪的纳维亚人；具有北欧日尔曼民族外貌特征的人 2.adj. 北欧人的；斯堪的纳维亚的；日耳曼民族的 
exclude	1.vt. 排除；排斥；拒绝接纳；逐出 
affects	1.n. 感情；引起感情的因素；情绪反应（affect的复数） 2.v. 影响；喜欢（affect的三单形式）；假装 
functions	1.n. [计] 功能；[数] 函数（function的复数形式） 
sponsored	1.v. 赞助（sponsor的过去分词）；发起 2.adj. 赞助的；发起的 
stall	1.n. 货摊；畜栏；托辞 2.vt. 拖延；使停转；使陷于泥中 3.vi. 停止，停转；拖延 4.n. (Stall)人名；(瑞典)斯塔尔 
adjusted	1.v. 调整；校正（adjust的过去分词） 2.adj. 调整过的，调节了的 
proclaime	
socialist	1.n. 社会主义者；社会党党员 2.adj. 社会主义的 
vicious	1.adj. 恶毒的；恶意的；堕落的；有错误的；品性不端的；剧烈的 2.n. (Vicious)人名；(英)维舍斯 
tablets	1.n. [药] 药片，匾（tablet的复数形式）；便笺 2.v. 用碑牌纪念；将…制成小片（tablet的第三人称单数） 
pushes	1.vt. 推动；增加；推行；逼迫 2.vi. 推；推进；增加；伸展；努力争取 3.n. 推；决心；奋力；攻击；干劲；进取心 
peso	1.n. 比索（拉丁美洲一些国家和菲律宾的货币单位）；美元 2.n. (Peso)人名；(西、意、芬)佩索 
occasional	1.adj. 偶然的；临时的；特殊场合的 
securing	1.v. 保卫；弄牢固（secure的ing形式） 2.adj. 固定住的；作为固定用的 
removal	1.n. 免职；移动；排除；搬迁 
disproportionate	1.adj. 不成比例的 2.不成比例地 
prostitution	1.n. 卖淫；滥用；出卖灵魂 
Californian	1.n. 加利福尼亚州人 2.adj. 加州的；加利福尼亚的 
commitments	1.n. 承诺，保证；委托；承担义务；献身 
realistic	1.adj. 现实的；现实主义的；逼真的；实在论的 
pollster	1.n. 民意测验专家，民意调查人；整理民意测验结果的人 2.n. (Pollster)人名；(英)波尔斯特 
echoes	1.n. 回声；共鸣；反响（echo的复数） 2.v. 发出回声；随声附和；与…相似（echo的单三形式） 
Serbia	1.n. 塞尔维亚（南斯拉夫成员共和国名） 
Nicolas	1.n. 尼古拉斯（男子名） 
Midlands	1.中部地区 
explanations	1.n. 解释（explanation的复数）；说明 
strategist	1.n. 战略家；军事家 
separation	1.n. 分离，分开；间隔，距离；[法] 分居；缺口 
naked	1.adj. 裸体的；无装饰的；无证据的；直率的 
Norwegian	1.n. 挪威人；挪威语 2.adj. 挪威的；挪威人的；挪威语的 
slipping	1.n. 滑动 2.v. 滑动（slip的现在分词） 3.adj. 渐渐松弛的 
pump	1.n. 泵，抽水机；打气筒 2.vt. 打气；用抽水机抽… 3.vi. 抽水 4.n. (Pump)人名；(捷)蓬普；(英)庞普 
fragmented	1.adj. 片断的；成碎片的 2.v. 分裂（fragment的过去分词）；使成碎片 
Bundestag	1.n. 西德连邦议会 
business-friendly	1.商业友好 
Rivera	1.n. 里韦拉（乌拉圭北部最重要的边境城市，里韦拉省首府） 
admitting	1.v. 承认（admit的ing形式） 
dragged	1.v. 制动；拖动；打滑；松懈 
quoted	1.v. 引证（quote的过去式） 
preference	1.n. 偏爱，倾向；优先权 
solely	1.adv. 单独地，唯一地 
Often	1.adv. 常常，时常 
fatal	1.adj. 致命的；重大的；毁灭性的；命中注定的 2.n. (Fatal)人名；(葡、芬)法塔尔 
infections	1.n. 传染病；口腔病害（infection复数形式） 
Mitchell	1.n. 米切尔（男子名，等于Michael） 
humour	1.n. 幽默（等于humor）；诙谐 2.vt. 迁就；使满足 
fade	1.n. [电影][电视] 淡出；[电影][电视] 淡入 2.adj. 平淡的；乏味的 3.vi. 褪色；凋谢；逐渐消失 4.vt. 使褪色 5.n. (Fade)人名；(法)法德 
Abdel	1.n. (Abdel)人名；(阿拉伯、哈萨、塔吉、吉尔、乌兹、阿塞、土库、乍、塞)阿卜杜勒 
romantic	1.n. 浪漫的人 2.adj. 浪漫的；多情的；空想的 3.vt. 使…浪漫化 
Samaras	1.n. (Samaras)人名；(希)萨马拉斯 
weakest	1.adj. 最弱的 
copied	1.v. 复制，复印（copy的过去分词） 2.adj. 复制的；已复制的 
ethanol	1.n. [有化] 乙醇，[有化] 酒精 
handout	1.n. 散发材料（免费发给的新闻通报）；上课老师发的印刷品；文字资料 （会议上分发的）；施舍物 
assistant	1.n. 助手，助理，助教 2.adj. 辅助的，助理的；有帮助的 
premature	1.n. 早产儿；过早发生的事物 2.adj. 早产的；不成熟的；比预期早的 
signalled	1.v. 标志着（signal的过去分词形式）；给…发信号；用信号传递 2.adj. 暗示的；告知的 
Ernst	1.n. 恩斯特（人名）；艾伦斯特（人名） 
noting	1.n. 注释，注释法；公证文件；提示 2.v. 记录，注解，注意（note的现在分词） 
Corker	1.n. 压塞机；塞瓶塞的人；出色的人 2.n. (Corker)人名；(英)科克 
Virgin	1.n. 处女 2.adj. 处女的；纯洁的；未经利用的，处于原始状态的 
inspectors	1.n. [经管] 检查员，巡视员（inspector的复数形式）；检查器 
correlation	1.n. [数] 相关，关联；相互关系 
pregnancy	1.n. 怀孕；丰富，多产；意义深长 
exploration	1.n. 探测；探究；踏勘 
long-standing	1.adj. 长期存在的；存在已久的 
liability	1.n. 责任；债务；倾向；可能性；不利因素 
watchdog	1.n. 看门狗；监察人；忠实的看守人 
graft	1.n. 移植；嫁接；渎职 2.vt. 移植；嫁接；贪污 3.vi. 移植；嫁接；贪污 4.n. （非正式）脚踏实地地埋头苦干 
administrative	1.adj. 管理的，行政的 
grievance	1.n. 不满，不平；委屈；冤情 
mortality	1.n. 死亡数，死亡率；必死性，必死的命运 
sprawling	1.adj. 蔓生的，不规则地伸展的 2.v. （手脚）不自然地伸开；笨拙地爬（sprawl的现在分词） 
frustrated	1.v. 挫败；阻挠（frustrate的过去式和过去分词形式） 2.adj. 失意的，挫败的；泄气的 
facility	1.n. 设施；设备；容易；灵巧 
tendency	1.n. 倾向，趋势；癖好 
Administration	1.n. 管理；行政；实施；行政机构 
eliminate	1.vt. 消除；排除 
phenomenon	1.n. 现象；奇迹；杰出的人才 
boundary	1.n. 边界；范围；分界线 
spark	1.n. 火花；朝气；闪光 2.vt. 发动；鼓舞；求婚 3.vi. 闪烁；发火花；求婚 4.n. (Spark)人名；(俄)斯帕克 
commonly	1.adv. 一般地；通常地；普通地 
constraint	1.n. [数] 约束；局促，态度不自然；强制 
resignation	1.n. 辞职；放弃；辞职书；顺从 
Sheikh	1.n. 族长；阿拉伯酋长（等于sheik） 
Latino	1.n. 拉丁美洲人 2.n. (Latino)人名；(意、葡)拉蒂诺 3.adj. 拉丁美洲的；拉丁美洲人的 
demonstrations	1.n. 示范，展示（demonstration复数） 
aggressive	1.adj. 侵略性的；好斗的；有进取心的；有闯劲的 
convincing	1.v. 使相信；使明白（convince的现在分词） 2.adj. 令人信服的；有说服力的 
Harper	1.n. 竖琴演奏人 
annexation	1.n. 合并；附加物 
extremism	1.n. 极端主义（尤指政治上的极右或极左）；极端性；过激主义 
teenage	1.n. 青少年时期 2.adj. 青少年的；十几岁的 
manages	1.n. 管理（manage的复数，等于managements） 2.v. 管理；控制；负责；设法对付（manage的三单形式） 
reversed	1.v. 颠倒（reverse的过去式和过去分词）；翻转 2.adj. 颠倒的；相反的；（判决等）撤销的 
caliphate	1.n. 伊斯兰教国王的职权或其领域 
developments	1.n. 发展；进展（development的复数）；建设 
containing	1.n. 包含 2.v. 包含；容纳；克制（contain的ing形式） 3.adj. 包含的；封闭的 
PSA	1.abbr. 美国摄影协会（Photographic Society of America ）；美国诗社（Poetry Society of America）；公共事业管理（Public Service Administration ）；公用事业协会（Public Service Association） 
Thaksin	1.塔克辛；塔辛（人名） 
crossing	1.n. 十字路口；杂交；横渡；横道 2.v. 横越（cross的现在分词） 
eventual	1.adj. 最后的，结果的；可能的；终于的 
neutral	1.n. 中立国；中立者；非彩色；齿轮的空档 2.adj. 中立的，中性的；中立国的；非彩色的 
enjoys	1.vt. 欣赏，享受；喜爱；使过得快活 
staged	1.v. stage过去式及过去分词 2.adj. 分期的 
embargo	
function	1.n. 功能；[数] 函数；职责；盛大的集会 2.vi. 运行；活动；行使职责 
rightly	1.adv. 正确地；恰当地；公正地；合适地 
automatically	1.adj. 不经思索的 2.adv. 自动地；机械地；无意识地 
breach	1.n. 违背，违反；缺口 2.vt. 违反，破坏；打破 
Harry	1.vt. 折磨；掠夺；骚扰；使苦恼 2.n. (Harry)人名；(英)哈里，哈丽(女名)(教名Henry、Harriet的昵称) 
County	1.n. 郡，县 
Louisiana	1.n. 美国路易斯安那州 
liberalisation	1.n. 自由化；开放 
hitherto	1.adv. 迄今；至今 
strengthened	1.v. 加强（strengthen的过去式） 
dubious	1.adj. 可疑的；暧昧的；无把握的；半信半疑的 
formidable	1.adj. 强大的；可怕的；令人敬畏的；艰难的 
SOE	1.n. (Soe)人名；(日)副(姓)；(瑞典)瑟；(缅)梭 2.abbr. 国有企业（state-owned enterprises）；事件顺序记录（Sequence Of Event）；特殊行动执行局（Special Operations Executive）；索尼在线娱乐公司（Sony Online Entertainment）；特别行动处（Special Operations Executive） 
stages	1.n. [计] 阶段（stage的复数）；舞台；戏剧表演 2.v. 计划；表演；分阶段进行（stage的三单形式） 
stagnation	1.n. 停滞；滞止 
reactors	1.n. [化工] 反应器（reactor的复数）；反应者 
hint	1.n. 暗示；线索 2.vt. 暗示；示意 3.vi. 示意 4.n. (Hint)人名；(英)欣特；(法)安特 
slashed	1.v. 削减（slash的过去式及过去分词） 
defences	1.n. 防御工事（defence复数） 
Tayyip	
rankings	1.n. 排名；排行（ranking的复数） 
provoke	1.vt. 驱使；激怒；煽动；惹起 
impressed	1.adj. 印象深刻的；外加的；受感动的；了不起的 
Columbia	1.n. 哥伦比亚 
backers	1.n. (Backers)人名；(英)巴克斯 
sole	1.n. 鞋底；脚底；基础；鳎目鱼 2.adj. 唯一的；单独的；仅有的 3.vt. 触底；上鞋底 4.n. (Sole)人名；(意、西、芬、塞、罗、南非)索莱 
prosecution	1.n. 起诉，检举；进行；经营 
heed	1.n. 注意到；留心到 2.vt. 注意，留心 3.vi. 注意，留心 4.n. (Heed)人名；(瑞典)赫德 
commit	1.vt. 犯罪，做错事；把...交托给；指派…作战；使…承担义务 
unionist	1.n. 工会会员；联合主义者 
Hague	1.n. 海牙（荷兰一座城市） 
NGO	1.abbr. 非政府组织（Non-Governmental Organization）；民间组织 2.n. (Ngo)人名；(喀)恩戈；(柬)努 
accompanied	1.v. 陪伴，伴随；伴奏（accompany的过去分词） 2.adj. 伴随的；相伴的 
offences	1.冒犯 2.犯规 3.违法行为 4.罪行(offence的复数） 
bears	1.n. 熊（bear的复数）；空头（卖空的证券交易投机） 
deposit	1.n. 存款；保证金；沉淀物 2.vt. 使沉积；存放 3.vi. 沉淀 
Kentucky	1.n. 肯塔基州 
sweet	1.n. 糖果；乐趣；芳香；宝贝 2.adj. 甜的；悦耳的；芳香的；亲切的 3.（俚）酷毙了 4.n. (Sweet)人名；(英)斯威特 
recall	1.n. 召回；回忆；撤消 2.vt. 召回；回想起，记起；取消 
Canal	1.n. 运河；[地理] 水道；[建] 管道；灌溉水渠 2.vt. 在…开凿运河 3.n. (Canal)人名；(英、法、西、意、葡)卡纳尔；(土)贾纳尔 
rushed	1.v. 急忙（rush的过去式）；匆促 2.adj. 匆忙的；贸然的 
researcher	1.n. 研究员 
grave	1.n. 墓穴，坟墓；死亡 2.adj. 重大的；严肃的；黯淡的 3.vt. 雕刻；铭记 4.n. (Grave)人名；(英)格雷夫；(德、瑞典)格拉弗；(法)格拉夫；(俄、葡)格拉韦 
discontent	1.n. 不满 2.adj. 不满的 3.vt. 使不满 
tired	1.v. 疲倦；对…腻烦（tire的过去分词形式） 2.adj. 疲倦的；厌倦的，厌烦的 
sacked	1.v. 解雇；洗劫；把…装进袋里；睡觉（sack的过去分词） 2.adj. 袋装的；被洗劫的 
attracting	1.诱集 
sufficient	1.adj. 足够的；充分的 
memoir	1.n. 回忆录；研究报告；自传；实录 
diversity	1.n. 多样性；差异 
Wayne	1.n. 韦恩（男子名） 
Nemtsov	
Immigration	1.n. 外来移民；移居 
arrangement	1.n. 布置；整理；准备 
destination	1.n. 目的地，终点 
demographic	1.adj. 人口统计学的；人口学的 
crew	1.n. 队，组；全体人员，全体船员 2.vt. 使当船员 3.vi. 一起工作 4.n. (Crew)人名；(英、西)克鲁 
bias	1.n. 偏见；偏爱；斜纹；乖离率 2.adj. 偏斜的 3.vt. 使存偏见 4.adv. 偏斜地 5.n. (Bias)人名；(法、德、葡、喀)比亚斯；(英)拜厄斯 
wholesale	1.n. 批发 2.adj. 批发的；大规模的 3.vt. 批发 4.adv. 大规模地；以批发方式 5.vi. 批发；经营批发业 
limiting	1.v. 限制；限定（limit的现在分词） 2.adj. 限制的；限制性的 
successes	1.n. 成功，成就；胜利；大获成功的人或事物 
gender	1.n. 性；性别；性交 2.vt. 生（过去式gendered，过去分词gendered，现在分词gendering，第三人称单数genders，形容词genderless） 
ensuring	1.v. 保证；确保；担保（ensure的现在分词） 
commerce	1.n. 贸易，商业 
Daniel	1.n. 丹尼尔（男子名） 
equities	1.n. 股票（equity的复数）；权益；股本；公平 
advocate	1.n. 提倡者；支持者；律师 2.vt. 提倡，主张，拥护 
discourage	1.vt. 阻止；使气馁 
distrust	1.n. 不信任 2.vt. 不信任 3.怀疑 
supreme	1.n. 至高；霸权 2.adj. 最高的；至高的；最重要的 
surge	1.n. 汹涌；大浪，波涛；汹涌澎湃；巨涌 2.v. 汹涌；起大浪，蜂拥而来 
intentions	1.n. 目的，意向，意图；打算（intention的复数） 
Bay	1.n. 海湾；狗吠声 2.vt. 向…吠叫 3.vi. 吠叫；大声叫嚷 4.n. (Bay)人名；(越)七；(英、老)贝；(德、意、罗、捷、土、丹)巴伊；(匈)鲍伊；(瑞典)巴伊 
orbit	1.n. 轨道；眼眶；势力范围；生活常规 2.vt. 绕…轨道而行 3.vi. 盘旋；绕轨道运行 
feeble	1.adj. 微弱的，无力的；虚弱的；薄弱的 
obscure	1.adj. 昏暗的，朦胧的；晦涩的，不清楚的；隐蔽的；不著名的，无名的 2.vt. 使…模糊不清，掩盖；隐藏；使难理解 3.n. 某种模糊的或不清楚的东西 
reference	1.n. 参考，参照；涉及，提及；参考书目；介绍信；证明书 2.vt. 引用 3.vi. 引用 
Tim	1.n. 蒂姆（男子名） 
subsequently	1.adv. 随后，其后；后来 
educational	1.adj. 教育的；有教育意义的 
sprawl	1.n. 蔓生；伸开手足躺卧姿势 2.vt. 懒散地伸开；使蔓生 3.vi. 蔓延；伸开手足躺；无计划地扩展 
passes	1.n. 关口；执照；通路（pass的复数） 2.v. 经过；传递（pass的三单形式）；超过；及格 
element	1.n. 元素；要素；原理；成分；自然环境 2.n. (Element)人名；(德)埃勒门特；(英)埃利门特 
regulate	1.vt. 调节，规定；控制；校准；有系统的管理 
technique	1.n. 技巧，技术；手法 
embassy	1.n. 大使馆；大使馆全体人员 
sticks	1.n. 棍；树枝；麻骨（stick复数形式） 2.v. 用杆支撑；刺死；插入（stick的第三人称单数） 
mystery	1.n. 秘密，谜；神秘，神秘的事物；推理小说，推理剧；常作 mysteries 秘技，秘诀 
Orban	1.欧尔班；奥尔班（人名，地名） 
Recep	1.n. (Recep)人名；(土)雷杰普 
lorries	1.n. 卡车（lorry的复数形式） 
Guantánamo	
Romney	1.n. 罗姆尼（男性名）；罗姆尼羊 
boast	1.n. 自夸；值得夸耀的事物，引以为荣的事物 2.vi. 自吹自擂 3.vt. 夸口说，自吹自擂说；以有…而自豪 4.n. (Boast)人名；(英)博斯特 
pop	1.n. 流行音乐；汽水；砰然声；枪击 2.abbr. 邮局协议（post office protocol） 3.adj. 流行的；通俗的；热门的 4.vt. 取出；开枪打；抛出；突然伸出；突然行动 5.adv. 突然；砰地 6.vi. 突然出现；爆开；射击；瞪大；发出爆裂声 7.n. (Pop)人名；(罗、捷、塞)波普 
Enrique	1.n. 恩里克（男子名） 
occurred	1.v. 发生（occur的过去分词） 
pack	1.n. 包装；一群；背包；包裹；一副 2.vt. 包装；压紧；捆扎；挑选；塞满 3.vi. 挤；包装货物；被包装；群集 4.n. (Pack)人名；(英、德)帕克 
heritage	1.n. 遗产；传统；继承物；继承权 2.n. (Heritage)人名；(英)赫里蒂奇 
militia	1.n. 民兵组织；自卫队；义勇军；国民军 
acknowledged	1.v. 承认；确认（acknowledge的过去式和过去分词）；答谢 2.adj. 公认的；被普遍认可的 
Heathrow	1.n. 希思罗机场（位于英国伦敦） 
malaria	1.n. [内科] 疟疾；瘴气 
guaranteed	1.v. 担保（guarantee的过去式和过去分词） 2.adj. 有保证的，；有人担保的 
compliance	1.n. 顺从，服从；承诺 
virtual	1.adj. [计] 虚拟的；实质上的，事实上的（但未在名义上或正式获承认） 
sluggish	1.n. 市况呆滞；市势疲弱 2.adj. 萧条的；迟钝的；行动迟缓的；懒惰的 
pharmaceutical	1.n. 药物 2.adj. 制药（学）的 
Nobel	1.n. 诺贝尔（瑞典化学家及发明家，发明炸药，创设诺贝奖）；诺贝尔（姓氏） 
exhibition	1.n. 展览，显示；展览会；展览品 
tolerance	1.n. 公差；宽容；容忍；公差 
provoked	1.v. 激起；挑衅（provoke的过去分词） 2.adj. 被激怒的；受到挑衅的 
obligations	1.n. [法] 义务；债务；承付款项（obligation的复数） 
Bureau	
high-tech	1.n. 高科技 2.adj. 高科技的，高技术的；仿真技术的 
bonuses	1.n. 奖金（bonus的复数形式） 
Santa	1.n. 圣诞老人（等于Santa Claus） 
broadband	1.n. 宽频；宽波段 2.adj. 宽频带的；宽波段的；宽频通讯的 
Liverpool	1.n. 利物浦 
Draghi	1.n. (Draghi)人名；(法、意)德拉吉 
Carlos	1.n. 卡洛斯（男子名） 
second-largest	
Kemp	1.n. 冠军；粗毛 2.n. (Kemp)人名；(法、荷、英、德、葡、西)肯普 3.vi. 收割竞赛 
asylum-seekers	
owed	1.vbl. 感恩；亏欠；负债] 
appointment	1.n. 任命；约定；任命的职位 
volatile	1.n. 挥发物；有翅的动物 2.adj. [化学] 挥发性的；不稳定的；爆炸性的；反覆无常的 3.n. (Volatile)人名；(意)沃拉蒂莱 
Nelson	1.n. 压住对方头部或颈后及一臂或二臂的手法 2.n. (Nelson)人名；(英、俄)纳尔逊；(德、西、葡、瑞典)内尔松 
lobbying	1.n. 游说 2.v. 进行游说（lobby的ing形式）；对议员进行游说以影响其投票 
convention	1.n. 大会；[法] 惯例；[计] 约定；[法] 协定；习俗 
condemned	1.adj. 已被定罪的；被责难的 
calculations	1.n. [数] 计算，运算（calculation的复数形式）；计算器 
Warren	1.n. 养兔场；大杂院；拥挤的地区 
reformist	1.n. 改革者；改革主义者 2.adj. 改良主义的；改良运动的 
lethal	1.n. 致死因子 2.adj. 致命的，致死的 
rampant	1.adj. 猖獗的；蔓延的；狂暴的；奔放的 2.n. (Rampant)人名；(法)朗庞 
troubling	1.n. 浊度；浑浊度 
rockets	1.n. [航] 火箭，烟火；火箭弹（rocket的复数形式） 2.v. 用火箭运载；飞速上升；猛涨（rocket的第三人称单数） 
sectarian	1.n. 属于宗派的人；宗派心强的人；宗派主义者 2.adj. 宗派的；偏狭的；党派心强的 
fixing	1.n. 固定；安装；设备；修理 2.v. 固定（fix的现在分词） 
concentrate	1.n. 浓缩，精选；浓缩液 2.vi. 集中；浓缩；全神贯注；聚集 3.vt. 集中；浓缩 
Alas	1.int. 唉（表悲伤、遗憾、恐惧、关切等等） 2.n. (Alas)人名；(西、葡、捷、土)阿拉斯 
tended	1.vi. 趋向，倾向；照料，照顾 2.vt. 照料，照管 
insurgents	1.n. 叛乱分子（insurgent的复数） 
Stanford	1.n. 斯坦福（姓氏，男子名）；斯坦福大学（美国一所大学） 
announce	1.vt. 宣布；述说；预示；播报 2.vi. 宣布参加竞选；当播音员 
reflected	1.v. 反射；思考（reflect的过去式和过去分词） 2.adj. 反射的；得自他人的 
encourages	1.鼓励 2.激励 3.受到鼓舞的 4.鼓舞 
statistical	1.adj. 统计的；统计学的 
referred	1.v. 参考，查阅（refer的过去式）；归类，谈及，送交 2.adj. 援引的 
radiation	1.n. 辐射；发光；放射物 
economically	1.adv. 经济地；在经济上；节俭地 
biological	1.adj. 生物的；生物学的 
profile	1.n. 侧面；轮廓；外形；剖面；简况 2.vt. 描…的轮廓；扼要描述 3.vi. 给出轮廓 
pilot	1.n. 飞行员；领航员 2.adj. 试点的 3.v. 驾驶；领航；试用 4.n. (Pilot)人名；(意、印)皮洛特；(法)皮洛 
horror	1.n. 惊骇；惨状；极端厌恶；令人恐怖的事物 
Kurdistan	1.n. 库尔德斯坦（西南亚库尔德人分布地区） 
erupted	1.v. 爆发；长出（erupt的过去分词） 
conversation	1.n. 交谈，会话；社交；交往，交际；会谈；（人与计算机的）人机对话 
Hampshire	1.n. 汉普郡（英国南部之一郡） 
ousted	1.驱逐 2.取代（oust的过去式和过去分词） 
clinics	1.n. 诊所（clinic的复数形式） 
canal	1.n. 运河；[地理] 水道；[建] 管道；灌溉水渠 2.vt. 在…开凿运河 3.n. (Canal)人名；(英、法、西、意、葡)卡纳尔；(土)贾纳尔 
ferry	1.n. 渡船；摆渡；渡口 2.vt. （乘渡船）渡过；用渡船运送；空运 3.vi. 摆渡；来往行驶 4.n. (Ferry)人名；(法、德、英、印尼)费里 
enduring	1.adj. 持久的；能忍受的 2.v. 忍耐（endure的ing形式） 
Uighurs	
pricey	1.adj. 高价的，过分昂贵的 
Catalan	1.n. 加泰罗尼亚语 2.adj. 加泰罗尼亚的；加泰罗尼亚语的 
siege	1.n. 围攻；包围；围城；不断袭击；长期努力 2.vt. 围攻；包围 
constituency	1.n. （选区的）选民；支持者；（一批）顾客 
formula	1.n. [数] 公式，准则；配方；婴儿食品 
compare	1.vi. 相比，匹敌；比较，区别；比拟（常与to连用） 2.vt. 比拟，喻为；[语]构成 3.n. 比较 4.n. (Compare)人名；(意)孔帕雷 
Holocaust	1.n. 大屠杀；毁灭 
vaccine	1.n. 疫苗；牛痘苗 2.adj. 疫苗的；牛痘的 
proteins	1.n. [生化] 蛋白质（protein复数） 
spectacular	1.adj. 壮观的，惊人的；公开展示的 
chapter	1.n. 章，回；（俱乐部、协会等的）分会；人生或历史上的重要时期 2.vt. 把…分成章节 
strategies	1.n. 策略，战略（strategy的复数形式） 
Inflation	1.n. 膨胀；通货膨胀；夸张；自命不凡 
ranging	1.n. 排列；测距修正 2.v. 移动；排列（range的ing形式）；分类 
categories	1.n. 类别（category的复数）；分类 
interim	1.n. 过渡时期，中间时期；暂定 2.adj. 临时的，暂时的；中间的；间歇的 
hostage	1.n. 人质；抵押品 
borrowed	1.v. 借；模仿；采用（borrow的过去分词） 2.adj. 借来的；虚构的 
Barclays	1.n. 巴克莱银行（公司名，财富500强公司之一，总部所在地英国，主要经营银行） 
working-age	
factions	1.n. 派系（faction的复数）；内讧 
Algeria	1.n. 阿尔及利亚（北非国家） 
cheered	1.v. 欢呼（cheer的过去分词） 
quarterly	1.n. 季刊 2.adj. 季度的，按季度的；一年四次的 3.adv. 按季度，[农] 一季一次地；纵横四分地 4.n. (Quarterly)人名；(英)夸特利 
overwhelming	1.adj. 压倒性的；势不可挡的 2.v. 压倒；淹没（overwhelm的ing形式）；制服 
flee	1.vt. 逃跑，逃走；逃避 2.vi. 逃走；消失，消散 
grants	1.n. 补助金；津贴（grant的复数）；政府奖助 2.v. [专利] 授予；同意；承认（grant的第三人称单数） 3.n. (Grants)人名；(瑞典)格兰茨 
refugee	1.n. 难民，避难者；流亡者，逃亡者 
legally	1.adv. 合法地；法律上 
imposing	1.v. impose的ing形式 2.adj. （建筑物等）壮观的；威风的；（仪表）堂堂的；给人深刻印象的 
enjoying	1.享受 2.享有 3.欣赏（enjoy的现在分词） 
serves	1.（网球）发球（serve的名词复数） 2.为…服务 3.供应 4.对待 5.任（职）（ serve的第三人称单数 ） 
closest	1.adj. 最靠近的（close的最高级） 
compensate	1.vt. 补偿，赔偿；付报酬 2.vi. 补偿，赔偿；抵消 
temporarily	1.adv. 临时地，临时 
Elizabeth	1.n. 伊丽莎白（女子名） 
Wisconsin	1.n. 威斯康星州（美国州名） 
excuse	1.n. 借口；理由 2.vt. 原谅；为…申辩；给…免去 3.vi. 作为借口；请求宽恕；表示宽恕 
reveals	1.n. 暴露（reveal第三人称单数） 2.vt. 揭示（reveal第三人称单数） 
operates	1.v. 操作；运行；动手术（operate的第三人称单数） 
fraction	1.n. 分数；部分；小部分；稍微 
enthusiastic	1.adj. 热情的；热心的；狂热的 
dire	1.adj. 可怕的；悲惨的；极端的 
Nazis	1.n. 纳粹；纳粹党人（nazi的复数） 
implications	1.n. 蕴涵式；暗指，暗示；含蓄，含意；卷入（implication的复数） 
insisting	1.坚持 
threw	1.v. 抛（throw的过去式）；丢弃 
devolved	1.移交 
cultures	1.n. 文明，文化（culture复数） 
unexpectedly	1.adv. 出乎意料地，意外地 
regain	1.n. 收复；取回 2.vt. 恢复；重新获得；收回 3.vi. 上涨 
shortfall	1.n. 差额；缺少 
viable	1.adj. 可行的；能养活的；能生育的 
tightened	1.v. 拉紧；固定；加严（tighten的过去式形式）；使紧密 
undermining	1.n. 底蚀作用；潜挖；淘空；底切 2.v. 在…下挖坑道；暗中破坏；逐渐损害（undermine的ing形式） 3.adj. 潜挖的；底蚀的 
insiders	1.n. [劳经] 内部人员（insider的复数）；局内人 
likelihood	1.n. 可能性，可能 
fancy	1.n. 幻想；想像力；爱好 2.adj. 想象的；奇特的；昂贵的；精选的 3.vt. 想象；喜爱；设想；自负 4.vi. 幻想；想象 5.n. (Fancy)人名；(法)方西 
permit	1.n. 许可证，执照 2.vt. 许可；允许 3.vi. 许可；允许 
observation	1.n. 观察；监视；观察报告 
designers	1.n. [建] 设计师，[建] 设计者；设计器（designer的复数形式） 
traces	1.n. [法] 痕迹；遗迹（trace的复数） 2.v. [审计] 追溯；[计][电子] 跟踪；摹写（trace的三单形式） 
landed	1.v. 登陆，登岸（land的过去时和过去分词） 2.adj. 拥有土地的；陆地上的 
Mount	1.n. 山峰；底座；乘骑用马；攀，登；运载工具；底座 2.vt. 增加；爬上；使骑上马；安装，架置；镶嵌，嵌入；准备上演；成立（军队等） 3.vi. 爬；增加；上升 4.n. （英）芒特（人名） 5.v. 登上；骑上 
messy	1.adj. 凌乱的，散乱的；肮脏的，污秽的；麻烦的 
Fidesz	
Eduardo	1.n. 爱德华多（姓氏） 
likelier	1.可能的（likely的比较级） 
Industrial	1.n. 工业股票；工业工人 2.adj. 工业的，产业的；从事工业的；供工业用的；来自勤劳的 
deciding	1.v. 决定（decide的现在分词） 2.adj. 决定性的；无疑的 
ignoring	1.v. 忽略，忽视（ignore的现在分词） 
Protection	1.n. 保护；防卫；护照 
amnesty	1.n. 大赦，特赦 2.vt. 对…实行大赦 
Donald	1.n. 唐纳德（男子名） 
non-profit	1.adj. 非营利的 
mall	1.n. 购物商场；林荫路；铁圈球场 2.n. (Mall)人名；(英)玛尔(女子教名 Mary 的昵称)；(阿拉伯)迈勒；(尼)马尔 
disrupt	1.vt. 破坏；使瓦解；使分裂；使中断；使陷于混乱 2.adj. 分裂的，中断的；分散的 
accountability	1.n. 有义务；有责任；可说明性 
Hugo	1.n. 雨果（男子名，等于Hugh） 
windfall	1.n. 意外之财；被风吹落的果子；意外的收获 
revenge	1.n. 报复；复仇 2.vt. 报复；替…报仇；洗雪 3.vi. 报仇；雪耻 
declaration	1.n. （纳税品等的）申报；宣布；公告；申诉书 
collaboration	1.n. 合作；勾结；通敌 
tighter	1.紧的（ tight的比较级 ） 
convenient	1.adj. 方便的；[废语]适当的；[口语]近便的；实用的 
stricter	1.严格的（ strict的比较级 ） 
owes	1.v. 亏欠；负债（owe的单三形式）；感恩 
Zimbabwe	1.n. 津巴布韦（国家名，位于非洲） 
Okinawa	1.n. 冲绳县（日本） 
Edinburgh	1.n. 爱丁堡（英国城市名） 
leap	1.n. 飞跃；跳跃 2.vt. 跳跃，跳过；使跃过 3.vi. 跳，跳跃 4.n. (Leap)人名；(法)莱亚 
Carnegie	1.n. 卡内基（姓氏） 
recruited	1.vt. 招聘，雇佣（recruit过去时形式）；招募 
classic	1.n. 名著；经典著作；大艺术家 2.adj. 经典的；古典的，传统的；最优秀的 
scratch	1.n. 擦伤；抓痕；刮擦声；乱写 2.vt. 抓；刮；挖出；乱涂 3.adj. 打草稿用的；凑合的；碰巧的 4.vi. 抓；搔；发刮擦声；勉强糊口；退出比赛 
gaps	1.n. 差异，缺口；缝隙（gap的复数形式） 2.v. 裂开；使豁裂（gap的第三人称单数形式） 
offence	1.n. 犯罪；违反；过错；攻击 
homeless	1.adj. 无家可归的 2.无家可归的人 3.无家可归 
Churchill	1.n. 邱吉尔（英国政治家及作家） 
belonging	1.n. 所有物；行李；附属物 
tactic	1.n. 策略，战略 2.adj. 按顺序的，依次排列的 
shell	1.n. 壳，贝壳；炮弹；外形 2.vt. 剥皮；炮轰 3.vi. 剥落；设定命令行解释器的位置 
architect	1.n. 建筑师 2.缔造者 
wheel	1.n. 车轮；方向盘；转动 2.vt. 转动；使变换方向；给…装轮子 3.vi. 旋转；突然转变方向；盘旋飞行 
Something	1.n. 重要的人；值得重视的事 2.adj. 大约；有点象 3.adv. 非常；有点；大约 4.pron. 某事；某物 
Rubio	1.n. (Rubio)人名；(意、葡)鲁比奥；(西)鲁维奥 
translated	1.n. 译本 2.v. 翻译（translate的过去分词） 
actor	1.n. 男演员；行动者；作用物 
robots	1.n. [自] 机器人（robot的复数形式） 
unwilling	1.adj. 不愿意的；不情愿的；勉强的 
Tiananmen	1.n. 天安门 
raid	1.n. 袭击；突袭；搜捕；抢劫 2.vt. 袭击，突袭 3.vi. 对…进行突然袭击 4.n. (Raid)人名；(阿拉伯)拉伊德 
travellers	1.n. 旅行者；钢领圈（traveller的复数） 
turbine	1.n. [动力] 涡轮；[动力] 涡轮机 
Sadly	1.adv. 悲哀地；悲痛地 
offspring	1.n. 后代，子孙；产物 
misery	1.n. 痛苦，悲惨；不幸；苦恼；穷困 2.n. (Misery)人名；(法)米斯里 
Fewer	1.adj. 较少的 2.int. 较少数 3.pron. 较少数 
doomed	1.adj. 注定的；命定的 2.v. 注定；宣判（doom的过去分词） 
veterans	1.n. 老兵；退伍军人（veteran的复数形式） 
existed	1.生存 2.存在 
overturned	1.v. 颠覆（overturn的过去式） 2.adj. 倾覆的，倒转的 
alter	1.vt. 改变，更改 2.vi. 改变；修改 3.n. (Alter)人名；(英)奥尔特；(德、捷、葡、爱沙、立陶、拉脱、俄、西、罗、瑞典)阿尔特 
Action	1.n. 行动；活动；功能；战斗；情节 2.n. (Action)人名；(英)埃克申 
Houston	1.n. 休斯顿（美国得克萨斯州港市） 
cosy	1.n. 保温罩 2.adj. 舒适的；惬意的 
Bloomberg	1.n. 彭博社；彭博资讯 
woo	1.vt. 追求；招致；向…求爱；恳求 2.vi. 求爱；恳求 
smuggling	1.n. 走私 2.v. 走私 3.偷运 
rows	1.n. 行（row的复数形式）；返回引用中的行数 2.v. 使列成一排（row的第三人称单数形式） 3.n. (Rows)人名；(英)罗斯 
hence	1.adv. 因此；今后 
earliest	1.n. 最早 2.adj. 早的；初期的 
Laos	1.n. 老挝 
Strategic	1.adj. 战略上的，战略的 
towers	1.n. [建] 塔；塔器；空中跳台（tower的复数） 2.n. (Towers)人名；(英)托尔斯 
extensive	1.adj. 广泛的；大量的；广阔的 
revealing	1.v. 揭示；展现（reveal的ing形式） 2.adj. 透露真情的；有启迪作用的；袒胸露肩的 
third-largest	
envoy	1.n. 使者；全权公使 
terminal	1.n. 末端；终点；终端机；极限 2.adj. 末端的；终点的；晚期的 
drove	1.n. 畜群；牛群、羊群等；移动的人群或大批的东西 2.(Drove)人名；德罗韦 3.v. 驾驶（drive的过去式） 
award	1.n. 奖品；判决 2.vt. 授予；判定 
filling	1.n. 填充；填料 2.v. 填满；遍及（fill的ing形式） 3.n. (Filling)人名；(瑞典)菲林 
decree	1.n. 法令；判决 2.vt. 命令；颁布；注定；判决 3.vi. 注定；发布命令 
blames	1.vt. 责备；归咎于 2.n. 责备；责任；过失 
acquisition	1.n. 获得物，获得 
Syrians	1.n. 叙利亚人（Syrian的复数） 
Clark	1.n. 克拉克（男子名） 2.n. (Clark)人名；(瑞典、葡、西、芬、斐、意、德、匈、英、土)克拉克 
dealings	1.n. 交易；来往 
removing	1.n. 消除；拆迁 2.v. 去除，移动（remove的分词形式） 
Lake	1.n. 湖；深红色颜料；胭脂红 2.vt. （使）血球溶解 3.vi. （使）血球溶解 4.n. (Lake)人名；(德、塞、瑞典)拉克；(英)莱克 
levy	1.n. 征收；征兵，征税 2.vt. 征收（税等）；征集（兵等） 3.vi. 征税；征兵 4.n. (Levy)人名；(西、意、葡、芬、法、瑞典)莱维；(英、以)利维 
Austria	1.n. 奥地利 
privileged	1.adj. 享有特权的；有特别恩典的 2.v. 给予…特权；免除（privilege的过去分词） 
panel	1.n. 仪表板；嵌板；座谈小组，全体陪审员 2.vt. 嵌镶板 3.n. (Panel)人名；(英、法)帕内尔 
Innovation	1.n. 创新，革新；新方法 
converted	1.v. 转变；改变信仰（convert的过去式和过去分词形式） 2.adj. 修改的；改变信仰的 
dioxide	1.n. 二氧化物 
brilliant	1.adj. 灿烂的，闪耀的；杰出的；有才气的；精彩的，绝妙的 
ceremony	1.n. 典礼，仪式；礼节，礼仪；客套，虚礼 
American-led	
errors	1.n. 误差；错误；差错（error的复数） 
populism	1.n. 民粹主义，平民主义 
Civil	1.adj. 公民的；民间的；文职的；有礼貌的；根据民法的 2.n. (Civil)人名；(土)吉维尔；(法)西维尔 
Looking	1.adj. 有…相貌的；有…样子的 
steam	1.n. 蒸汽；精力 2.adj. 蒸汽的 3.vt. 蒸，散发；用蒸汽处理 4.vi. 蒸，冒水汽 
competent	1.adj. 胜任的；有能力的；能干的；足够的 
Tennessee	1.n. 田纳西州（美国州名） 
Ted	1.vt. 翻晒 
tastes	1.n. [食品] 味道，品味（taste的复数形式） 2.v. 体会，尝（taste的三单形式） 
boasted	1.v. v.有（引以为荣的事物）( boast的过去式和过去分词 )； 扬言 
sounded	1.vbl. 听起来 
assured	1.n. 被保险人 2.v. 保证；确实（assure的过去分词） 3.adj. 确定的；自信的 
Gujarat	1.n. 古吉拉特邦（印度西部的邦） 
rotten	1.adj. 腐烂的；堕落的；恶臭的；虚弱的；极坏的 2.adv. 非常 3.n. (Rotten)人名；(法、德)罗滕 
campaigned	1.vi. 作战；参加竞选；参加活动 2.n. 运动；活动；战役 
readily	1.adv. 容易地；乐意地；无困难地 
mount	1.n. 山峰；底座；乘骑用马；攀，登；运载工具；底座 2.vt. 增加；爬上；使骑上马；安装，架置；镶嵌，嵌入；准备上演；成立（军队等） 3.vi. 爬；增加；上升 4.n. （英）芒特（人名） 5.v. 登上；骑上 
finger	1.n. 手指；指针，指状物 2.vt. 伸出；用手指拨弄 3.vi. 用指触摸；拨弄 4.n. (Finger)人名；(英、德、捷)芬格；(俄)芬格尔 
confined	1.v. 限制（confine的过去式和过去分词） 2.adj. 狭窄的；幽禁的；有限制的；在分娩中的 
musical	1.n. 音乐片 2.adj. 音乐的；悦耳的 
accusations	1.n. 控告，指控；谴责 
endured	1.v. 忍耐（endure的过去式） 
patchy	1.adj. 不调和的；拼凑成的；有补丁的 
clusters	1.n. [植] 簇；丛（cluster的复数形式）；[计] 群集 
Tata	1.n. 散步；机关枪 2.n. (Tata)人名；(印、土、意)塔塔 3.int. 再见 
suited	1.v. 适合（suit的过去分词） 2.adj. 合适的 
transistors	1.n. [电子] 晶体管；晶体三极管（transistor的复数） 
Warner	1.n. 警告者；报警器 2.n. (Warner)人名；(英)沃纳；(德、瑞典)瓦尔纳 
institute	1.n. 学会，协会；学院 2.vt. 开始（调查）；制定；创立；提起（诉讼） 
Rockefeller	1.n. 洛克菲勒（姓氏） 
painted	1.v. 油漆（paint的过去式和过去分词） 2.adj. 描画的；着色的；刷上油漆的 3.n. (Painted)人名；(瑞典)帕因特德 
transparent	1.adj. 透明的；显然的；坦率的；易懂的 
Uribe	1.乌里韦 2.乌里韦 
haul	1.n. 拖，拉；用力拖拉；努力得到的结果；捕获物；一网捕获的鱼量；拖运距离 2.vt. 拖运；拖拉 3.vi. 拖，拉；改变主意；改变方向 4.n. (Haul)人名；(德)豪尔 
poured	1.n. 倾泻；流出；骤雨 2.vt. 灌，注；倒；倾泻；倾吐 3.vi. 倾泻；涌流；斟茶 4.n. (Pour)人名；(伊朗)普尔；(捷)保尔 
idle	1.adj. 闲置的；懒惰的；停顿的 2.vt. 虚度；使空转 3.vi. 无所事事；虚度；空转 
hearts	1.n. [解剖] 心；内心；中心；同情心；心形物（heart的复数） 2.v. 铭记；用心材支撑（heart的三单形式） 
disability	1.n. 残疾；无能；无资格；不利条件 
Thames	1.n. （伦敦的）泰晤士河 
peaked	1.v. 到达高点，消瘦，竖起（peak的过去式和过去分词形式） 2.adj. 尖的；消瘦的；有遮檐的 
priced	1.v. 给…定价（price的过去分词） 2.adj. [物价] 附有定价的 
initiatives	
signing	1.n. 签署；签字 2.v. 签字；写下；示意（sign的ing形式） 
terminal	1.n. 末端；终点；终端机；极限 2.adj. 末端的；终点的；晚期的 
inclined	1.v. 使…倾向（incline的过去分词） 2.adj. 趋向于…的 
Revolution	1.n. 革命；旋转；运行；循环 
Things	1.n. 事物（thing的复数形式）；用品；形势 
fastest-growing	
lean	1.n. 瘦肉；倾斜；倾斜度 2.adj. 瘦的；贫乏的，歉收的 3.vt. 使倾斜 4.vi. 倾斜；倚靠；倾向；依赖 5.n. (Lean)人名；(西)莱安；(柬)连；(英)利恩 
Sales	1.n. 销售（sale的复数）；销售额 2.adj. 销售的，售货的；有关销售的 3.n. (Sales)人名；(意、西、葡)萨莱斯；(法)萨勒；(英)塞尔斯 
Romania	1.n. 罗马尼亚（欧洲巴尔干半岛东北部国家） 
Matthew	1.n. 马太（耶稣12门徒之一）；马修（姓氏，男子名）；马太福音（新约第一卷） 
therapy	1.n. 治疗，疗法 
throwing	1.n. 投掷 2.v. 掷（throw的ing形式） 
assembled	1.v. 装配（assemble的过去分词）；集合 2.adj. 组合的；安装的 
excluded	1.v. 排除（exclude的过去式和过去分词）；驱逐；拒绝接纳 2.adj. 排除的 
Istanbul	1.n. 伊斯坦布尔（土耳其城市） 
Tibet	1.n. 西藏（中国一自治区） 
launching	1.n. 发射；下水；创设 2.v. 发射；发动；开始从事（launch的ing形式） 
speakers	1.n. [电子] 扬声器；发言者（speaker的复数）；演说家 
surrender	1.n. 投降；放弃；交出；屈服 2.vt. 使投降；放弃；交出；听任 3.vi. 投降；屈服；自首 
pressed	1.v. 压（press的过去式） 2.adj. 加压的；紧迫的 
shores	1.滨 
imprisoned	1.adj. 被封印，被囚禁的 
payroll	1.n. 工资单 
boon	1.n. 恩惠；福利；利益 2.adj. 愉快的；慷慨的 3.n. (Boon)人名；(英)布恩；(东南亚国家华语)文；(瑞典、德)博恩；(泰)汶 
ubiquitous	1.adj. 普遍存在的；无所不在的 
processing	1.v. 加工；[自] 处理；对…起诉（process的ing形式） 
viewed	1.n. 观察；视野；意见；风景 2.vt. 观察；考虑；查看 
predictable	1.adj. 可预言的 
obsessed	1.v. 着迷（obsess的过去式）；纠缠 2.adj. 着迷的；无法摆脱的 
Military	1.n. 军队；军人 2.adj. 军事的；军人的；适于战争的 
promotion	1.n. 提升，[劳经] 晋升；推销，促销；促进；发扬，振兴 
flock	1.n. 群；棉束（等于floc） 2.vi. 聚集；成群而行 3.vt. 用棉束填满 4.n. (Flock)人名；(德、瑞典)弗洛克 
appealed	1.v. 呼吁（appeal的过去分词）；求助；诉请 
Bruce	1.n. 布鲁斯（男名） 
volunteer	1.n. 志愿者；志愿兵 2.adj. 志愿的 3.vt. 自愿 4.vi. 自愿 
slumped	1.adj. 下跌的；倒下的 2.v. 掉落（slump的过去分词形式） 
planted	1.vbl. 种植 
slavery	1.n. 奴役；奴隶制度；奴隶身分 
lock	1.n. 锁；水闸；刹车 2.vt. 锁，锁上；隐藏 3.vi. 锁；锁住；卡住 4.n. (Lock)人名；(英、丹、德、瑞典)洛克 
locations	1.n. 位置；地点（location的复数）；定位件 
treasury	1.n. 国库，金库；财政部；宝库 
bullying	1.n. 恃强欺弱的行为 2.v. 欺负（bully的现在分词） 
happily	1.adv. 快乐地；幸福地；幸运地；恰当地 
flower	1.n. 花；精华；开花植物 2.vt. 使开花；用花装饰 3.vi. 成熟，发育；开花；繁荣；旺盛 4.n. (Flower)人名；(英)弗劳尔 
deadly	1.adj. 致命的；非常的；死一般的 2.adv. 非常；如死一般地 
urge	1.n. 强烈的欲望，迫切要求；推动力 2.vi. 强烈要求 3.vt. 力劝，催促；驱策，推进 
undermine	1.vt. 破坏，渐渐破坏；挖掘地基 
capability	1.n. 才能，能力；性能，容量 
rebuild	1.vt. 重建；改造，重新组装；复原 2.vi. 重建 
strife	1.n. 冲突；争吵；不和 
harbour	1.n. 海港（等于harbor）；避难所 2.vt. 庇护；藏匿；入港停泊 3.vi. 藏匿；入港停泊；庇护 4.n. (Harbour)人名；(英)哈伯 
cater	1.vt. 投合，迎合；满足需要；提供饮食及服务 2.n. (Cater)人名；(英)凯特 
shorter	1.adj. 较短的；更短的；更矮的（short的比较级） 2.n. (Shorter)人名；(英)肖特 
recalled	1.vt. 召回；回想起，记起；取消 2.n. 召回；回忆；撤消 
theories	1.n. 理论（theory的复数形式） 
Prince	1.n. 王子，国君；亲王；贵族 2.n. (Prince)人名；(英、葡)普林斯；(法)普兰斯； 
maintenance	1.n. 维护，维修；保持；生活费用 
steep	1.n. 峭壁；浸渍 2.adj. 陡峭的；不合理的；夸大的；急剧升降的 3.vt. 泡；浸；使…充满 4.vi. 泡；沉浸 
Sony	1.n. 索尼（日本电子娱乐公司） 2.n. (Sony)人名；(中非、印尼)索尼 
engaging	1.v. 参加（engage的ing形式）；保证；雇用 2.adj. 迷人的 
Bulgaria	1.n. 保加利亚 
abound	1.vi. 富于；充满 
Lidl	
gravitational	1.adj. [力] 重力的，[力] 引力的 
Brian	1.n. 布莱恩（男子名） 
peculiar	1.n. 特权；特有财产 2.adj. 特殊的；独特的；奇怪的；罕见的 
absorb	1.vt. 吸收；吸引；承受；理解；使…全神贯注 
desk	1.n. 办公桌；服务台；编辑部；（美）讲道台；乐谱架 2.adj. 书桌的；桌上用的；伏案做的 
vacuum	1.n. 真空；空间；真空吸尘器 2.adj. 真空的；利用真空的；产生真空的 3.vt. 用真空吸尘器清扫 
Pakistanis	1.n. 巴基斯坦人（Pakistani的复数） 
muscle	1.n. 肌肉；力量 2.vt. 加强；使劲搬动；使劲挤出 3.vi. 使劲行进 
territories	1.n. 地区；领土；边疆区（territory的复数） 
fractious	1.adj. 易怒的；倔强的，难以对待的 
youngest	1.n. 最小的儿子；年纪最小的人 2.adj. 最年轻的 
prolonged	1.adj. 延长的；拖延的；持续很久的 
concentration	1.n. 浓度；集中；浓缩；专心；集合 
cleaning	1.n. 清洗；清除；去污；大败 2.v. 清洁（clean的ing形式） 
redistribution	1.n. [经] 重新分配 
championed	1.n. 冠军；拥护者；战士 2.vt. 支持；拥护 3.adj. 优胜的；第一流的 4.n. (Champion)人名；(英)钱皮恩；(法)尚皮翁 
stir	1.n. 搅拌；轰动 2.vi. 搅动；传播；走动 3.vt. 搅拌；激起；惹起 
immunity	1.n. 免疫力；豁免权；免除 
invite	1.n. 邀请 2.vt. 邀请，招待；招致 
stiff	1.adj. 呆板的；坚硬的；严厉的；拘谨的 2.adv. 僵硬地；彻底地 3.n. 死尸；令人讨厌者；流通票据；劳动者 4.vt. 诈骗；失信 
submarine	1.n. 潜水艇；海底生物 2.adj. 海底的；水下的 3.vt. 用潜水艇攻击 4.vi. 在下疾行；在下滑动 
impunity	1.n. 不受惩罚；无患；[法] 免罚 
massacre	1.n. 大屠杀；惨败 2.vt. 残杀；彻底击败 3.n. (Massacre)人名；(法)马萨克尔 
lasted	1.vbl. 持续 
appearance	1.n. 外貌，外观；出现，露面 
clearing	1.n. 结算；空地；清扫 2.v. 澄清；放晴（clear的ing形式） 
withdrew	1.v. 收回（withdraw的过去式） 
traditions	1.传统 
Shias	
populous	1.adj. 人口稠密的；人口多的 
Kent	1.n. 肯特（英国东南部州名）；不列颠岛南部的古代盎格鲁所建的王国 
Consumers	1.n. [经][生态] 消费者，消耗者；用户，顾客（consumer的复数） 
buyer	1.n. 买主；采购员 2.n. (Buyer)人名；(英)拜尔；(法)比耶；(德)布耶尔 
licensing	1.v. 许可；批准（license的ing形式） 
Khan	1.n. 可汗（对最高统治者的尊称）；商队客店 2.n. (Khan)人名；(瑞典)卡恩；(老、柬)坎 
Reliance	1.n. 信赖；信心；受信赖的人或物 
metre	1.n. 米；公尺；韵律 2.n. (Metre)人名；(英)米特 
Baltimore	1.n. 巴尔的摩（美国一座港市） 
riches	1.n. 财富；富有；房地产（rich的复数） 2.n. (Riches)人名；(意)里凯斯；(英)里奇斯 
dose	1.n. 剂量；一剂，一服 2.vt. 给药；给…服药 3.vi. 服药 4.n. (Dose)人名；(德)多泽；(意、西、葡、塞)多塞；(英)多斯 
boundary	1.n. 边界；范围；分界线 
roof	1.n. 屋顶；最高处，顶部；最高限度 2.vt. 给…盖屋顶，覆盖 3.n. (Roof)人名；(英)鲁夫 
Palace	1.n. 宫殿；宅邸；豪华住宅 
belongs	1.v. 属于（belong的第三人称单数） 
hardware	1.n. 计算机硬件；五金器具 
responding	1.n. 反应 2.v. 反应；作答（respond的ing形式） 3.adj. 响应的 
successor	1.n. 继承者；后续的事物 
copper	1.n. 铜；铜币；警察 2.adj. 铜的 3.vt. 镀铜于 4.n. (Copper)人名；(英)科珀 
Larry	1.n. 拌浆锄；小车，[矿业] 斗底车 
fluid	1.n. 流体；液体 2.adj. 流动的；流畅的；不固定的 
Stockholm	1.n. 斯德哥尔摩（瑞典首都） 
fiercest	1.（尤指人或动物）凶猛的 2.（尤指动作或情感）强烈的 3.（天气或温度）恶劣的（fierce的最高级） 
midst	1.n. 当中，中间 2.prep. 在…中间（等于amidst） 
Aquino	1.阿基诺（人名） 
aligned	1.v. 结盟（align的过去式）；使成一直线 2.adj. 对齐的；均衡的 
heating	1.n. [热] 加热；[建] 供暖；暖气设备 2.v. [热] 加热（heat的现在分词） 3.adj. 加热的；供热的 
ordering	1.n. 订购；[计] 排序；[计] 定序 2.v. 订购（order的ing形式）；命令；指挥 
unrelated	1.adj. 无关的，不相干的 
devote	1.vt. 致力于；奉献 
Colombian	1.n. 哥伦比亚人 2.adj. 哥伦比亚的 
intrusive	1.adj. 侵入的；打扰的 
grades	1.n. 等级（grade的复数形式）；分数 2.v. 将…分等级；给…评成绩（grade的三单形式） 3.n. (Grades)人名；(葡)格拉德斯 
automation	1.n. 自动化；自动操作 
harassment	1.n. 骚扰；烦恼 
occasions	1.n. 场合；机会（occasion的复数）；理由 2.v. 致使；引起（occasion的第三人称单数） 
Haiti	1.n. 海地 
central-bank	
surviving	1.adj. 继续存在的；未死的；依然健在的 2.v. 生存（survive的ing形式） 
Jabhat	
bizarre	1.adj. 奇异的（指态度，容貌，款式等） 
passports	1.n. [法] 护照，通行证（passport复数形式） 
privatise	
unsustainable	1.adj. 无法支撑的；不可证实的；不能成立的 
Rosneft	1.n. 俄罗斯石油公司 
Austrian	1.n. 奥地利人 2.adj. 奥地利的；奥地利人的 
censorship	1.n. 审查制度；审查机构 
tyres	1.n. [橡胶] 轮胎；车胎（tyre的复数） 2.v. 给…装轮胎（tyre的三单形式） 
perilous	1.adj. 危险的，冒险的 
misleading	1.v. 给…带错路；把…引入歧途（mislead的ing形式） 2.adj. 令人误解的；引入歧途的 
robber	1.n. 强盗；盗贼 
Hamid	1.n. 哈米德（人名） 
high-profile	1.adj. 高调的；备受瞩目的；知名度高的 
hung	1.v. 悬挂；垂落（hang的过去式和过去分词） 2.n. (Hung)人名；(老)亨；(中)洪(普通话·威妥玛)；(朝)兴；(东南亚国家华语)勋 
indices	1.n. 目录（index的复数） 
physicists	1.n. 物理学家；机械唯物论者（physicist的复数） 
sulphur	1.n. 硫磺；硫磺色 2.vt. 使硫化；用硫磺处理 
queues	1.n. [数] 队列；行列（queue的复数形式） 2.v. [数] 排队（queue的第三人称单数） 
Teach	1.vt. 教；教授；教导 2.vi. 教授；讲授；当老师 3.n. (Teach)人名；(英)蒂奇 
Moore	1.n. 摩尔（男子名） 
candidacy	1.n. 候选资格；候选状态 
Dozens	1.n. 许多（dozen的复数） 
eroded	1.v. 侵蚀；损坏（erode的过去分词形式） 2.adj. 被侵蚀的，损坏了 
sanctioned	1.制裁 
vendors	1.n. 供应商，销售商（vendor的复数） 
disclosure	1.n. [审计] 披露；揭发；被揭发出来的事情 
Nisman	
heirs	1.n. [法] 继承人；继承者（heir的复数形式） 
martial	1.adj. 军事的；战争的；尚武的 2.n. (Martial)人名；(法)马夏尔 
cracks	1.n. [高分子] 裂缝，裂纹；龟裂（crack的复数形式）；板间间隙 2.v. 使破裂；砰地一声打开（crack的三单形式） 
well-off	1.adj. 富裕的；顺利的，走运的；繁荣昌盛的 
earners	1.n. 赚钱的人 
Herzog	1.赫尔佐克（人名） 
cafés	
mistrust	1.n. 不信任；怀疑 2.vt. 不信任；怀疑 3.vi. 不信任；怀疑 
derivatives	1.派生物 
spouses	1.配偶 
Colombians	1.n. 哥伦比亚人（Colombian的复数） 
injection	1.n. 注射；注射剂；充血；射入轨道 
delicate	1.adj. 微妙的；精美的，雅致的；柔和的；易碎的；纤弱的；清淡可口的 
Egyptians	1.n. 埃及人 2.与古埃及相关的 3.古埃及人 4.埃及文化的 
Argentines	1.银（argentine的名词复数） 2.银色素 3.银色工艺材料 
tissues	1.n. [组织] 组织，薄的纱织品；面巾纸（tissue的复数） 
Religion	1.n. 宗教；宗教信仰 
nicotine	1.n. [有化] 尼古丁；[有化] 烟碱 
landmark	1.n. [航]陆标；地标；界标；里程碑；纪念碑；地界标；划时代的事 2.adj. 有重大意义或影响的 3.n. （瑞典、挪）兰德马克（人名） 
nod	1.n. 点头；打盹；摆动 2.vt. 点头；点头表示 3.vi. 点头；打盹；摆动 
seeds	1.n. 种子；种子选手（seed的复数）；种子状物；子孙后代 2.v. 播种；取出…的核；催化（seed的第三人称单数） 3.n. (Seeds)人名；(英)西兹 
Seattle	1.n. 西雅图（美国一港市） 
Rosetta	1.n. 罗塞塔（城市名） 
vested	1.v. （财产、权利等）授予（vest的过去式和过去分词）；使穿衣服 2.adj. 既定的；穿着衣服（尤指祭服）的；（美）带背心的（指西服套装） 
wreck	1.n. 破坏；失事；残骸；失去健康的人 2.vt. 破坏；使失事；拆毁 3.vi. 失事；营救失事船只 
bloc	1.n. 集团 2.n. (Bloc)人名；(法、罗)布洛克 
spells	1.n. 符咒；魅力（spell的复数）；一段时间 2.v. 拼写（spell的第三人称单数） 
correctly	1.adv. 正确地；得体地 
implicit	1.adj. 含蓄的；暗示的；盲从的 
amendment	1.n. 修正案；改善；改正 
fading	1.n. 褪色；衰退；凋谢 2.v. 使衰落（fade的ing形式）；褪色 
Texan	1.n. 得克萨斯州的人 2.adj. 得克萨斯州的；德克萨斯州人的 
integrate	1.n. 一体化；集成体 2.adj. 整合的；完全的 3.vi. 求积分；取消隔离；成为一体 4.vt. 使…完整；使…成整体；求…的积分；表示…的总和 
emotions	1.n. [心理] 情绪；[心理] 情感（emotion的复数形式） 
loom	1.n. 织布机；若隐若现的景象 2.vt. 在织布机上织 3.vi. 可怕地出现；朦胧地出现；隐约可见 4.n. (Loom)人名；(瑞典)洛姆 
aerospace	1.n. 航空宇宙；[航] 航空航天空间 
capped	1.v. 给…戴帽；去蒂；覆以…；除去盖子；胜过（cap的过去分词形式） 2.adj. 包过的；加盖的；去蒂的 
Anthony	1.n. 安东尼（人名） 
startling	1.adj. 令人吃惊的 
quote	1.n. 引用 2.vi. 报价；引用；引证 3.vt. 报价；引述；举证 
exacerbated	1.vt. 加重（病情，痛苦等）；使…恶化；激怒（exacerbate的过去式） 
modelled	1.n. 模范，典型，榜样；模型 2.adj. 模范的，榜样的；用作模型的 3.vt. 做…模型；(用泥、蜡)塑造：；仿特定样式做出，按特定模型制造(或设计)： 
defenders	1.n. 后卫；防御者（defender的复数） 
warriors	1.战士 
mob	1.n. 暴民，暴徒；民众；乌合之众 2.vt. 大举包围，围攻；蜂拥进入 3.vi. 聚众生事，聚众滋事 
fairness	1.n. 公平；美好；清晰；顺利性 
sheets	1.n. [材] 片材，板片（sheet复数）；[纺] 被单 2.v. 覆盖（sheet的第三人称单数形式）；使成大片；铺床单 3.n. (Sheets)人名；(英)希茨 
inspections	1.n. 检查；视察；安全检测（inspection的复数） 
testimony	1.n. [法] 证词，证言；证据 
renewal	1.n. 更新，恢复；复兴；补充；革新；续借；重申 
refineries	1.n. 精炼厂（refinery的复数形式） 
deterred	1.vt. 制止，阻止；使打消念头 2.n. (Deter)人名；(德)德特尔 
bombings	1.n. [军] 轰炸，[军] 投弹 2.v. 轰击；引爆炸弹（bomb的ing形式） 
cheque	1.n. 支票 
compatriots	1.n. 同胞（compatriot复数） 
nostalgia	1.n. 乡愁；怀旧之情；怀乡病 
celebrating	1.v. 庆祝（celebrate的现在分词） 
exacerbate	1.vt. 使加剧；使恶化；激怒 
Mikhail	1.米哈伊尔（人名） 
viral	1.adj. 滤过性毒菌引起的；滤过性毒菌的 
PISA	1.n. 比萨（意大利城市） 
alarmed	1.v. 报警（alarm的过去式及过去分词） 2.adj. 惊恐的；受惊的；焦虑的 
outsider	1.n. 外人；无取胜希望者 
miserable	1.adj. 悲惨的；痛苦的；卑鄙的 
Libyan	1.n. 利比亚人；古代利比亚语 2.adj. 利比亚的；利比亚人的 
bolstered	1.支撑着的（bloster的变体） 2.加固的（bloster的变体） 
Anglo-Saxon	
alienated	1.v. 使疏离（alienate的过去式） 2.adj. 疏远的；被疏远的 
projections	1.n. 预测，推测（projection的复数形式）；[数][测] 投影；发射，规划；突出部分 
bind	1.n. 捆绑；困境；讨厌的事情；植物的藤蔓 2.vt. 绑；约束；装订；包扎；凝固 3.vi. 结合；装订；有约束力；过紧 4.n. (Bind)人名；(德)宾德 
resource	1.n. 资源，财力；办法；智谋 
terrain	
laments	1.n. 挽歌；恸哭；悲痛之情 2.vi. 哀悼；悲叹；悔恨 3.vt. 哀悼；痛惜 4.n. (Lament)人名；(葡)拉门特；(法)拉芒 
breathe	1.vi. 呼吸；低语；松口气；（风）轻拂 2.vt. 呼吸；使喘息；流露；低声说 
Nicholas	1.n. 尼古拉斯（男子名） 
drastically	1.adv. 彻底地；激烈地 
wasteful	1.adj. 浪费的，不经济的；奢侈的 
Ghana	1.n. 加纳（非洲西部国家） 
analyses	1.n. 分析；解析；分解；梗概（analysis的复数形式） 
reflecting	1.v. 反射；表明；考虑（reflect的ing形式） 2.adj. 反射的；沉思的 
Furthermore	1.adv. 此外；而且 
punitive	1.adj. 惩罚性的；刑罚的 
contracted	1.v. 使收缩；订契约（contract的过去式和过去分词） 2.adj. 契约的；收缩了的；狭小的 
uniquely	1.adv. 独特地；珍奇地 
instrument	1.n. 仪器；工具；乐器；手段；器械 
prototype	1.n. 原型；标准，模范 
tunnel	1.n. 隧道；坑道；洞穴通道 2.vt. 挖；在…打开通道；在…挖掘隧道 3.vi. 挖掘隧道；打开通道 
partially	1.adv. 部分地；偏袒地 
downtown	1.n. 市中心区；三分线以外 2.adj. 市中心的 3.adv. 往闹市区；在市区 
fast-food	1.n. 快餐食品 2.adj. 供应快餐的 
Laurent	1.n. 劳伦（法国数学家） 
solved	1.v. 解决（solve的过去式）；解答 2.adj. 解决了的 
nurses	1.n. [医] 护士；褓姆，看护（nurse的复数） 2.v. 护理；细心照看（nurse的第三人称单数） 
Morales	1.n. 莫拉莱斯（人名） 
gripped	1.vt. 紧咬，夹住；紧握（grip过去时形式） 
Aécio	
listings	1.表 
clutch	1.n. 离合器；控制；手；紧急关头 2.vt. 抓住；紧握 3.adj. 没有手提带或背带的；紧要关头的 4.vi. 攫；企图抓住 
simplify	1.vt. 简化；使单纯；使简易 
looser	1.宽松的 2.散漫的 3.不牢固的 4.不精确的（loose的比较级） 5.n. (Looser)人名；(瑞典)洛塞 
Bond	1.n. 债券；结合；约定；粘合剂 2.vt. 使结合；以…作保 3.vi. 结合，团结在一起 4.n. (Bond)人名；(英、德、西、刚(金)、瑞典)邦德 
grabbed	1.v. 攫取；捕获；强夺；匆忙地做（grab的过去分词形式） 
tragic	1.adj. 悲剧的；悲痛的，不幸的 
tank	1.n. 坦克；水槽；池塘 2.vt. 把…贮放在柜内；打败 3.vi. 乘坦克行进 4.n. (Tank)人名；(德、土、阿塞、土库、挪)汤克 
resorted	1.n. 凭借，手段；度假胜地；常去之地 2.vi. 求助，诉诸；常去；采取某手段或方法 
insistence	1.n. 坚持，强调；坚决主张 
Marcus	1.n. [机] 大铁锤 
thwart	1.prep. 横过 2.n. 划手座；独木舟的横梁 3.vt. 挫败；反对；阻碍；横过 4.adj. 横放的；固执的 5.adv. 横过 
Boehner	1.博纳（人名） 
aired	1.通风 2.夸耀 3.晾干（air的过去式和过去分词） 
staggering	1.adj. 蹒跚的；令人惊愕的；犹豫的 2.v. 蹒跚（stagger的ing形式） 
reformer	1.n. 改革家；改革运动者；改良者 
legislatures	1.n. 立法机关（legislature的复数） 
Yudhoyono	
lined	1.v. 排队（line的过去分词）；填满 2.adj. 有内衬的；具线纹的 
embarked	1.vi. 从事，着手；上船或飞机 2.vt. 使从事；使上船 
fend	1.vi. 照料；供养；力争 2.vt. 谋生；保护；挡开；供养 
wondering	1.v. 想知道（wonder的ing形式）；惊奇 2.adj. 疑惑的；觉得奇怪的 
Schmidt	1.n. 施密特（姓氏） 
ERC	1.abbr. 经济研究委员会（Economic Research Council）；电子设备研究中心（Electronic Research Center） 
Bosnia	1.n. 波斯尼亚；波士尼亚 
Vucic	
heels	1.n. 高跟鞋（heel的复数）；脚踝；残余料 2.v. 紧跟；给（鞋等）装跟（heel的三单形式） 
verge	1.n. 边缘 2.vi. 濒临，接近；处在边缘 3.n. (Verge)人名；(英)弗奇；(西)贝尔赫 
optimists	1.n. 乐观主义者；乐天派 
shaky	1.adj. 摇晃的；不可靠的；不坚定的 
containers	1.n. [包装] 容器；[交] 集装箱 
Figures	1.n. 价格，金额，[数] 数字；人物（figure的复数）；[数] 图形，图表；规定动作 2.n. (Figures)人名；(英)菲格斯 
Downing	1.唐宁 
traced	1.v. 追溯（trace的过去分词）；跟踪；摹写 2.adj. 示踪的；摹写的 
imperfect	1.n. 未完成体 2.adj. 有缺点的；未完成的；半过去的；未完成时的 3.adv. 有瑕疵地；有缺点地 
sweat	1.n. 汗；水珠；焦急；苦差使 2.vt. 使出汗；流出；使干苦活；剥削；藉出汗减轻；焦急地期待 3.vi. 出汗；辛苦工作；懊恼；结水珠 
infectious	1.adj. 传染的；传染性的；易传染的 
entrance	1.n. 入口；进入 2.vt. 使出神，使入迷 
exporter	1.n. 出口商；输出国 
merchant	1.n. 商人，批发商；店主 2.adj. 商业的，商人的 3.n. (Merchant)人名；(英)麦钱特 
philosophy	1.n. 哲学；哲理；人生观 
Zionist	1.n. 犹太复国主义者 2.adj. 犹太复国主义者的 
Garcia	1.n. 加西亚（姓氏） 
comet	1.n. [天] 彗星 2.n. (Comet)人名；(法)科梅 
mansion	1.n. 大厦；宅邸 2.n. (Mansion)人名；(法)芒雄 
construct	1.n. 构想，概念 2.vt. 建造，构造；创立 
Reforms	1.n. 改革（reform的复数） 2.v. 改革（reform的单数第三人称） 
taxpayer	1.n. 纳税人；所收租金只够支付地产税的建筑物 
sealed	1.v. 封闭；盖印（seal的过去分词） 2.adj. 密封的；未知的 
queue	1.n. 队列；长队；辫子 2.vt. 将…梳成辫子；使…排队 3.vi. 排队；排队等候 
bubbles	1.n. 泡沫；气泡（bubble的复数） 2.v. 沸腾；冒泡；发出气泡声（bubble的第三人称单数形式） 
overdue	1.adj. 过期的；迟到的；未兑的 
depressed	1.adj. 沮丧的；萧条的；压低的 2.v. 使沮丧；使萧条（depress的过去式和过去分词形式）；压低 
pledging	1.n. 保证；抵押；抵押物，典当物 2.v. 保证（pledge的ing形式）；抵押；向…祝酒 
survivors	1.n. 幸存者（survivor的复数） 
foolish	1.adj. 愚蠢的；傻的 
passive	1.n. 被动语态 2.adj. 被动的，消极的；被动语态的 
hurting	1.v. 伤害；伤心；弄痛（hurt的ing形式） 2.adj. 受伤害的；受损的 
Uruguay	1.n. 乌拉圭（拉丁美洲国家） 
navigate	1.vi. 航行，航空 2.vt. 驾驶，操纵；使通过；航行于 
prefecture	1.n. 县；管区，辖区；地方官的任期 
honoured	1.光荣 
hell	1.n. 地狱；究竟（作加强语气词）；训斥；黑暗势力 2.vi. 过放荡生活；飞驰 3.int. 该死；见鬼（表示惊奇、烦恼、厌恶、恼怒、失望等） 4.n. (Hell)人名；(柬)海；(西)埃利；(德、匈、捷、罗、芬、瑞典)黑尔 
forum	1.n. 论坛，讨论会；法庭；公开讨论的广场 
al-Nusra	
jurisdiction	1.n. 司法权，审判权，管辖权；权限，权力 
plummeted	1.n. [测] 铅锤，坠子 2.vi. 垂直落下；（价格、水平等）骤然下跌 
sacred	1.adj. 神的；神圣的；宗教的；庄严的 
swimming	1.n. 游泳；目眩 2.adj. 游泳的；游泳用的；善于游泳的；晕眩的 3.v. 游泳；漂浮；旋转（swim的ing形式） 
MDGs	1.联合国千年发展目标（Millennium Development Goals） 
tropical	1.adj. 热带的；热情的；酷热的 
Roosevelt	1.n. 罗斯福（姓氏，美国第26任总统） 
Tencent	1.腾讯公司 
justification	1.n. 理由；辩护；认为有理，认为正当；释罪 
loosely	1.adv. 宽松地；放荡地；轻率地 
refers	1.参考 2.查阅 3.归诸于 4.使…求助于（refer的第三人称单数） 
overtaken	1.v. 赶上，压倒（overtake的过去分词） 
FEW	1.n. 很少数 2.adj. 很少的；几乎没有的 3.pron. 很少 4.n. (Few)人名；(英)菲尤 
carmaking	
AstraZeneca	1.n. 阿斯利康（公司名） 
strictly	1.adv. 严格地；完全地；确实地 
desks	1.n. 桌子（desk的复数）；[家具] 书桌 
dispersed	1.v. 分散；传播（disperse的过去分词） 2.adj. 散布的；被分散的；被驱散的 
spiritual	1.n. 圣歌（尤指美国南部黑人的） 2.adj. 精神的，心灵的 
preserved	1.adj. 保藏的；腌制的；喝醉的 2.n. (Preserved)人名；(英)普里泽夫德 
insight	1.n. 洞察力；洞悉 2.n. (Insight)人名；(英)因赛特 
Wilson	1.n. 威尔逊（姓氏） 
impoverished	1.adj. 穷困的；用尽了的，无创造性的 2.v. 使贫困（impoverish的过去分词） 
morale	1.n. 士气，斗志 2.n. (Morale)人名；(意、西)莫拉莱 
hearings	1.n. 听证会；倾听；[生理] 听觉（hearing的复数） 
restricting	1.n. 整形，限制；扼流 2.v. 限制（restrict的ing形式） 
vastly	1.adv. 极大地；广大地；深远地 
separated	1.v. 分开；隔开（separate的过去式和过去分词） 2.adj. 分开的；分居；不在一起生活的 
fascinating	1.adj. 迷人的；吸引人的；使人神魂颠倒的 2.v. 使…着迷；使…陶醉（fascinate的ing形式） 
CCTV	1.abbr. 闭路电视（Closed Circuit Television）；中国中央电视台（China Central Television） 
high-end	1.adj. 高端的；高档的 
Opposition	1.n. 反对；反对派；在野党；敌对 
Industries	1.n. 行业，工业；实业公司（industry的复数） 
credited	1.v. 相信；记入贷方（credit的过去式和过去分词） 
desired	1.v. 渴望，要求（desire的过去分词形式） 2.adj. 渴望的；想得到的 
poetry	1.n. 诗；诗意，诗情；诗歌艺术 
abandoning	1.v. 放弃；屈服（abandon的现在分词） 
Nairobi	1.n. 内罗比（肯尼亚首都） 
flooding	1.n. 泛滥；产后出血 
relentlessly	1.adv. 残酷地，无情地 
Tikrit	1.提克里特（伊拉克城市） 
supporter	1.n. 支持者；拥护者 
Christie	1.n. 克里斯蒂（姓氏）；挪威首都奥斯陆的旧称 
cubic	1.adj. 立方体的，立方的 2.n. (Cubic)人名；(罗)库比克 
tolerant	1.adj. 宽容的；容忍的；有耐药力的 
Alberta	1.n. 亚伯达（加拿大西部的一个省） 
Peshawar	1.n. 白沙瓦（巴基斯坦北部城市） 
greeted	1.v. 迎接；问候；向…致敬（greet的过去式及过去分词形式） 
parole	1.n. 语言；誓言，诺言；释放宣言 2.vt. 有条件释放，假释；使假释出狱；宣誓后释放 
Pistorius	1.n. (Pistorius)人名；(德、捷)皮斯托留斯 
Co-operation	1.n. 合作；协作 
prescription	1.n. 药方；指示；惯例 2.adj. 凭处方方可购买的 
enhance	1.vt. 提高；加强；增加 
perks	1.n. 特权；额外津贴（perk的复数）；特别待遇 2.v. 打扮；使振作；昂首挺胸（perk的第三人称单数） 3.n. (Perks)人名；(英)珀克斯；(法)佩尔克 
corporate-tax	
professions	1.n. 行业（profession的复数形式）；职业；专业 
astonishing	1.adj. 惊人的；令人惊讶的 2.v. 使…惊讶；使…诧异（astonish的ing形式） 
trivial	1.adj. 不重要的，琐碎的；琐细的 
inconvenient	1.adj. 不便的；打扰的 
repressive	1.adj. 镇压的；压抑的；抑制的 
embedded	1.v. 嵌入（embed的过去式和过去分词形式） 2.adj. 嵌入式的；植入的；内含的 
ballots	1.n. 选举（ballot的复数）；不记名票 2.v. 投票（ballot的第三人称单数） 
pit	1.n. 矿井；深坑；陷阱；（物体或人体表面上的）凹陷；（英国剧场的）正厅后排；正厅后排的观众 2.vt. 使竞争；窖藏；使凹下；去…之核；使留疤痕 3.vi. 凹陷；起凹点 4.n. (Pit)人名；(东南亚国家华语)必 
defaulted	1.违约 2.在另外的可能性没有发生的情况下 3.原样的 4.默认值 
distress	1.n. 危难，不幸；贫困；悲痛 2.vt. 使悲痛；使贫困 
loopholes	1.n. 漏洞；枪眼（loophole的复数） 
Capitol	1.n. 美国国会大厦；（美国）州议会大厦 
CHICAGO	1.n. 芝加哥（美国城市名） 
Rahm	1.n. (Rahm)人名；(英、德、西、芬、瑞典)拉姆 
proudly	1.adv. 傲慢地，自负地；得意洋洋地 
Maine	1.n. 缅因州（美国州名） 
flagship	1.n. 旗舰；（作定语）一流；佼佼者 
trusts	1.n. [贸易] 信托；信任（trust的复数形式） 2.v. 相信（trust的三单形式）；委托 
eradication	1.n. 消灭，扑灭；根除 
relish	1.n. 滋味；风味；食欲；开胃小菜；含义；调味品 2.vt. 盼望;期待;享受; 品味；喜爱；给…加佐料 3.vi. 有特定意味；味道可口 
admission	1.n. 承认；入场费；进入许可；坦白；录用 
Cambodian	1.n. 柬埔寨人（高棉人）；柬埔寨语 2.adj. 柬埔寨的；柬埔寨人的；柬埔寨语的 
strongman	1.n. 强人；铁腕人物 
assertive	1.adj. 肯定的；独断的；坚定而自信的 
fractured	1.adj. 断裂的；挫伤的；折裂的 2.v. 断裂（fracture的过去式） 
malaise	1.n. 不舒服；心神不安 2.n. (Malaise)人名；(德、瑞典)马莱塞 
defied	1.v. 违抗（defy的过去式） 2.adj. 受蔑视的；遭违抗的 
exceeds	1.vt. 超过；胜过 2.vi. 超过其他 
indirect	1.adj. 间接的；迂回的；非直截了当的 
maturity	1.n. 成熟；到期；完备 
monarch	1.n. 君主，帝王；最高统治者 
arming	1.n. 武装；装备；徽章 
performances	1.n. 演出；[法] 履行（performance的复数形式） 
commentator	1.n. 评论员，解说员；实况播音员；时事评论者 
embattled	1.adj. 严阵以待的；被敌人围困的；心烦意乱的；边缘呈雉形的 2.v. 列阵；筑垒于（embattle的过去式和过去分词） 
hammer	1.n. 铁锤；链球；[解剖] 锤骨；音锤 2.vi. 锤击；敲打；重复 3.vt. 锤击；锤打 4.n. (Hammer)人名；(法)阿梅；(德、英、芬、捷、瑞典、荷、丹、挪)哈默 
torn	1.v. 扯裂，撕开（tear的过去分词） 2.n. (Torn)人名；(英、俄、捷)托恩 
commuter	1.n. 通勤者，经常乘公共车辆往返者；[交] 月季票乘客 
sights	1.n. 风景，名胜；视野（sight的复数） 2.v. 瞄准（sight的第三人称单数）；仔细观看 
repeal	1.n. 废除；撤销 2.vt. 废除；撤销；废止；放弃；否定 
humble	1.adj. 谦逊的；简陋的；（级别或地位）低下的；不大的 2.vt. 使谦恭；轻松打败（尤指强大的对手）；低声下气 
obtained	1.v. 获得（obtain的过去分词） 
clarity	1.n. 清楚，明晰；透明 2.n. (Clarity)人名；(英)克拉里蒂 
sighs	1.n. 叹息；手势；标记（sigh的复数） 
Duke	1.n. 公爵，（公国的）君主；公爵（种）樱桃 2.n. (Duke)人名；(西、俄、瑞典、英)杜克 
Students	1.n. （尤指大专院校的）学生（student的复数） 
deployment	1.n. 调度，部署 
faltering	1.adj. 蹒跚的；犹豫的；支吾的 2.v. 支吾地说，蹒跚地走（falter的现在分词） 
Regional	1.adj. 地区的；局部的；整个地区的 
mixing	1.n. 混合；[电子] 混频 2.v. 混合（mix的ing形式） 
positively	1.adv. 肯定地；明确地；断然地 
composition	1.n. 作文，作曲，作品；[材] 构成；合成物；成分 
expired	1.v. 期满（expire的过去分词） 2.adj. 过期的；失效的 
confusing	1.v. 使迷惑；使混乱不清；使困窘（confuse的ing形式） 2.adj. 混乱的；混淆的；令人困惑的 
susceptible	1.n. 易得病的人 2.adj. 易受影响的；易感动的；容许…的 
neutrinos	1.n. 中微子（neutrino的复数） 
shoots	1.n. 嫩枝 
extinction	1.n. 消失；消灭；废止 
violation	
psychological	1.adj. 心理的；心理学的；精神上的 
comedy	1.n. 喜剧；喜剧性；有趣的事情 
spirits	1.n. 态度（spirit的复数）；精力 2.v. 使振作（spirit的第三人称单数形式） 
confused	1.v. 困惑（confuse的过去式） 2.adj. 困惑的；混乱的；糊涂的 
banner	1.n. 旗帜，横幅；标语 2.n. (Banner)人名；(英、德、罗)班纳 
recommend	1.vt. 推荐，介绍；劝告；使受欢迎；托付 2.vi. 推荐；建议 
relieve	1.vt. 解除，减轻；使不单调乏味；换…的班；解围；使放心 
Putting	1.n. 投掷；（高尔夫球）打球入洞 2.v. 放置（put的ing形式）；轻击球；使球入洞的轻击（putt的ing形式） 
Protestant	1.n. 抗议者；持异议者 2.adj. 抗议的；持异议的 
swathe	1.n. 带子，绷带；包装品 2.vt. 包围；紧绑；裹 
Agriculture	1.n. 农业；农耕；农业生产；农艺，农学 
interest-rate	
demonstrating	1.n. 演示 2.v. 证明；示威（demonstrate的现在分词）；显示 
interviewed	1.v. 面试；接见；会见（interview的过去式） 
Keystone	1.n. 主旨，基本原则；[建] 楔石 
Uncle	1.n. 叔叔；伯父；伯伯；舅父；姨丈；姑父 
fluent	1.adj. 流畅的，流利的；液态的；畅流的 
eliminating	1.v. 消除（eliminate的ing形式） 2.adj. 排除的 
Malcolm	1.n. 马尔科姆（男子名） 
Scalia	1.斯卡利亚（人名） 
maintains	1.vt. 维持；继续；维修；主张；供养 
turbulent	1.adj. 骚乱的，混乱的；狂暴的；吵闹的；激流的，湍流的 
enrolled	1.v. 登记（入会；卷） 
inflicted	1.把…强加给 2.使承受（inflict的过去式和过去分词） 
criticising	1.vt. 批评；吹毛求疵；非难 2.vi. 批评；吹毛求疵；非难 
tactical	1.adj. 战术的；策略的；善于策略的 
anti-Semitic	1.adj. 反对犹太人的；排犹的 
primarily	1.adv. 首先；主要地，根本上 
intervened	1.干涉 2.介入（intervene的过去式和过去分词） 
co-ordinate	1.n. 坐标 2.v. 使……协调 3.adj. [生物] 同等的；并列的 
harming	1.损害 2.伤害 3.免于伤害 4.将不受损害 
landowners	1.n. 地主（landowner的复数形式）；土地所有者 
custom	1.n. 习惯，惯例；风俗；海关，关税；经常光顾；[总称]（经常性的）顾客 2.adj. （衣服等）定做的，定制的 
anomaly	1.n. 异常；不规则；反常事物 
variable	1.n. [数] 变量；可变物，可变因素 2.adj. 变量的；可变的；易变的，多变的；变异的，[生物] 畸变的 
exercises	1.n. 练习题，演习；运动 
keener	1.n. （爱尔兰）哭丧女（尤指职业的哭丧女人） 2.n. (Keener)人名；(英)基纳 
processed	1.v. 处理，加工（process的过去形式） 2.adj. 处理的，加工过的 
aggrieved	1.v. 侵害，伤害（aggrieve的过去分词形式）；使悲痛 2.adj. 受委屈的，愤愤不平的；权利受到不法侵害的 
characteristics	1.n. 特性，特征；特色（characteristic的复数）；特质 
bands	1.n. 乐队；法官 
haven	1.n. 港口；避难所，安息所 2.vt. 为……提供避难处；安置……于港中 3.n. (Haven)人名；(英)黑文 
hazard	1.n. 危险，冒险；冒险的事 2.vt. 赌运气；冒…的危险，使遭受危险 3.n. (Hazard)人名；(法)阿扎尔；(英)哈泽德 
template	1.n. 模板，样板 
density	1.n. 密度 
adept	1.n. 内行；能手 2.adj. 熟练的；擅长…的 
addressing	1.n. 寻址，定址；访问 
thread	1.n. 线；螺纹；思路；衣服；线状物；玻璃纤维；路线 2.vt. 穿过；穿线于；使交织 3.vi. 通过；穿透过 
performing	1.v. 表演（perform的ing形式）；履行 2.adj. 表演的；履行的 
sailing	1.n. 航行，航海；启航；航海术 2.v. 航行，起航（sail的现在分词形式） 3.adj. 航行的 
Hawaii	1.n. 夏威夷（美国州名）；夏威夷岛 
mosques	1.n. 清真寺（mosque的复数形式） 
Nepalese	1.n. 尼泊尔人 2.adj. 尼泊尔的 
livestock	1.n. 牲畜；家畜 
climate-change	
tweet	1.n. 小鸟叫声；自录音再现装置发出的高音；推特 2.vi. 吱吱地叫；啾鸣 
mentality	1.n. 心态；[心理] 智力；精神力；头脑作用 
resurgence	1.n. 复活；再现；再起 
portray	1.vt. 描绘；扮演 
dignity	1.n. 尊严；高贵 
disillusioned	1.v. 使幻想破灭（disillusion的过去分词）；唤醒 2.adj. 醒悟的；幻想破灭的；不抱幻想的 
refrain	1.n. 叠句，副歌；重复 2.vi. 节制，克制；避免；制止 
millennium	1.n. 千年期，千禧年；一千年，千年纪念；太平盛世，黄金时代 
dealmaking	
speculative	1.adj. 投机的；推测的；思索性的 
perils	1.n. 事故；风险（peril的复数） 2.v. 冒险；置…于危险中（peril的第三人称单数） 
peg	1.n. 钉；桩；借口；琴栓 2.vt. 限制；钉木钉 3.adj. 越往下端越细的 4.vi. 疾行；孜孜不倦地做某事 5.n. (Peg)人名；(英)佩格(女子教名 Margaret 的昵称)；(西)佩格 
spate	1.n. 洪水；一阵；大雨；突然迸发 
reign	1.n. 统治；统治时期；支配 2.vi. 统治；支配；盛行；君临 
rejects	1.n. 不良品；[环境] 选矿废渣；尾矿（reject的复数） 2.v. 拒绝；抛弃（reject的第三人称单数形式） 
tangible	1.n. 有形资产 2.adj. 有形的；切实的；可触摸的 
worn	1.v. 穿；磨损（wear的过去分词）；佩戴 2.adj. 疲倦的；用旧的 3.n. (Worn)人名；(柬)翁；(英、葡)沃恩 
Mission	1.n. 使命，任务；代表团；布道 2.vt. 派遣；向……传教 
Sirisena	1.n. (Sirisena)人名；(斯里)西里塞纳 
pinch	1.n. 匮乏；少量；夹痛 2.vt. 捏；勒索；使苦恼；掐掉某物，修剪 3.vi. 夹痛；节省 4.n. (Pinch)人名；(英)平奇 
dissidents	1.公开大唱反调者 2.持异议者 3.持不同政见者 
sceptics	1.n. 怀疑论者（sceptic的复数）；持怀疑态度的人 
twins	1.n. 双生子，双胞胎（twin的复数） 
Apollo	1.n. 阿波罗（太阳神）；美男子 
competitor	1.n. 竞争者，对手 
embracing	1.n. 拥抱 2.v. 拥抱，包含（embrace的现在分词形式） 
grumbling	1.adj. 出怨言的；喃喃鸣不平的 
aliens	1.n. 外星人（alien的复数）；外国人 2.v. 使疏远（alien的单三形式） 
ensured	1.确保 2.使安全 
Steinmeier	
timid	1.adj. 胆小的；羞怯的 
token	1.n. 表征；代币；记号 2.adj. 象征的；表意的；作为对某事的保证的 3.vt. 象征；代表 
Terry	1.n. 厚绒布；毛毛圈 2.n. (Terry)人名；(英、西、葡、法、塞)特里 3.adj. 起毛毛圈的 
bout	1.n. 回合；较量；发作；一阵 2.n. (Bout)人名；(法)布特 
Ministers	1.n. 部长（minister的复数）；阁僚 2.v. 伺候；照顾（minister的第三人称单数形式） 
loyalists	1.n. 拥护者；效忠派；保皇派（loyalist的复数） 
hapless	1.adj. 运气不好的，倒霉的 
borough	1.n. 区；自治的市镇 2.n. (Borough)人名；(英)伯勒 
interrupted	1.adj. 中断的；被打断的；不规则的 2.vt. 打断；中断（interrupt的过去分词） 
networking	1.n. 计算机网络的设计；一种互助性的网络体系 2.v. 交流（network的ing形式）；联络 
spectacle	1.n. 景象；场面；奇观；壮观；公开展示；表相，假相 n.（复）眼镜 
Reef	1.n. 暗礁；[地质] 矿脉；收帆 2.vt. 收帆；缩帆 3.vi. 缩帆；收帆 
bounced	1.n. 空头支票 2.v. 反弹；弹跳（bounce的过去分词）；跳起；开空头支票 
onshore	1.adj. 陆上的；向着海岸的 2.adv. 在陆上；向着海岸 
Cable	1.n. 缆绳；电缆；海底电报 2.vt. 打电报 3.vi. 打海底电报 
muster	1.n. 集合；检阅；点名册；集合人员 2.vt. 召集；对…进行点名；使振作 3.vi. 召集；聚集 4.n. (Muster)人名；(德、罗)穆斯特尔；(英)马斯特 
inmate	1.n. (尤指)同院病人；同狱犯人；同被(收容所)收容者 
contractor	1.n. 承包人；立契约者 
compiled	1.v. 编辑（compile的过去分词） 2.adj. 编译的 
Liberty	1.n. 自由；许可；冒失 2.n. (Liberty)人名；(英)利伯蒂 
Collins	1.n. 柯林斯（姓氏名）；柯林斯酒 
ash	1.n. 灰；灰烬 2.n. (Ash)人名；(英、俄、捷)阿什 
enlightened	1.v. 启迪（enlighten的过去式） 2.adj. 开明的；文明的；进步的；被启发的 
requested	1.v. 要求（request的过去分词）；[计] 请求 2.adj. 要求的；被请求的 
striving	1.n. 努力；斗争 2.v. 努力（strive的现在分词）；奋斗；力争 
extravagant	1.adj. 奢侈的；浪费的；过度的；放纵的 
Toronto	1.n. 多伦多（加拿大城市） 
coincidence	1.n. 巧合；一致；同时发生 
reformed	1.v. 改革（reform的过去分词和过去式） 2.adj. 改革过的；新教的 
releasing	1.n. 释放；松释动作；脱扣释放 2.v. 释放；排放（release的现在分词） 
cattle	1.n. 牛；牲畜（骂人的话）；家畜；无价值的人 2.n. (Cattle)人名；(意)卡特莱 
centenary	1.n. 一百年；百年纪念 2.adj. 一百年的 
youths	1.n. 青少年；青年时代 
confirms	1.确认 2.证实（confirm的第三人称单数） 
shiny	1.adj. 有光泽的，擦亮的；闪耀的；晴朗的；磨损的 
two-party	1.adj. 两大政党的 
mice	1.n. 老鼠（mouse的复数） 2.n. (Mice)人名；(塞)米采 
largesse	1.n. 慷慨的赠与；慷慨赠与物（等于largess） 
reacted	1.v. 反应；起作用（react的过去分词形式） 
accession	1.n. 增加；就职；到达 2.vt. 登记入册 
commercially	1.adv. 商业上；通商上 
ions	1.n. [化学] 离子（ion复数） 2.n. (Ions)人名；(英)艾恩斯 
cruel	1.adj. 残酷的，残忍的；使人痛苦的，让人受难的；无情的，严酷的 
Gallery	1.n. 画廊；走廊；旁听席；地道 2.vt. 在…修建走廊；在…挖地道 3.vi. 挖地道 4.n. (Gallery)人名；(英)加勒里 
Jordanian	1.n. 约旦人 2.adj. 约旦的；约旦人的 
flourishing	1.adj. 繁荣的；繁茂的；盛行的 2.v. 茂盛（flourish的ing形式） 
unwelcome	1.n. 冷淡 2.adj. 不受欢迎的；讨厌的；不被接受的 3.vt. 冷淡地对待 
pillar	1.n. 柱子，柱形物；栋梁；墩 2.vt. 用柱支持 3.n. (Pillar)人名；(英)皮勒 
Goodluck	1.n. (Goodluck)人名；(英)古德勒克 
Review	1.n. 回顾；复习；评论；检讨；检阅 2.vt. 回顾；检查；复审 3.vi. 回顾；复习功课；写评论 
files	1.n. [计] 文件；[图情][计] 文档（file的复数） 2.v. 提出（file的第三人称单数）；发送；汇订 3.n. (Files)人名；(英)法尔斯；(法)菲勒 
wares	1.n. [贸易] 商品；货物 2.n. (Wares)人名；(英)韦尔斯 
eats	1.abbr. 设备准确度测试站（Equipment Accuracy Test Station） 
scholarship	1.n. 奖学金；学识，学问 
flames	1.n. [化工] 火焰；火苗（flame的复数形式） 
Russell	1.n. 拉塞尔（英国工程师，整流器发明人） 
romance	1.n. 传奇；浪漫史；风流韵事；冒险故事 2.vi. 虚构；渲染；写传奇 3.n. (Romance)人名；(西)罗曼塞 
audit	1.n. 审计；[审计] 查帐 2.vt. （美）旁听 3.vi. 审计；[审计] 查帐 
steering	1.n. 操纵；指导；掌舵 2.v. 驾驶；掌舵（steer的ing形式） 
Hasina	
Smartphones	1.智能手机（smartphone的复数） 
dictators	1.n. 独裁者；命令者 
notions	1.n. 观念（notion的复数）；小商品 
transmit	1.vt. 传输；传播；发射；传达；遗传 2.vi. 传输；发射信号 
lurch	1.n. 突然倾斜；蹒跚；挫折 2.vt. 击败 3.vi. 倾斜；蹒跚 4.n. (Lurch)人名；(德)卢尔希 
tabloid	1.n. 小报；药片；文摘；小型画报 2.adj. 小报式的；缩略的；轰动性的；扼要的 
Fiat	1.n. 命令；许可；政法 2.vt. 批准；颁布 3.n. (Fiat)人名；(西)菲亚特 4.n. 菲亚特（意大利汽车品牌） 
underperforming	1.vt. （股票等）运作差于（一般市场价格） 2.vi. 表现不佳；工作不如预期（或同行） 
pessimistic	1.adj. 悲观的，厌世的；悲观主义的 
Did	1.v. 做（do的过去式） 
Fiction	1.n. 小说；虚构，编造；谎言 
rings	1.n. 吊环（ring的复数） 2.n. (Rings)人名；(德)林斯 
provocative	1.n. 刺激物，挑拨物；兴奋剂 2.adj. 刺激的，挑拨的；气人的 
nonsense	1.n. 胡说；废话 2.adj. 荒谬的 3.int. 胡说！ 
Rules	1.n. [数] 规则；条例（rule的复数形式） 2.v. 统治；支配；裁定（rule的第三人称单数形式） 
exhaust	1.n. 排气；废气；排气装置 2.vt. 排出；耗尽；使精疲力尽；彻底探讨 3.vi. 排气 
indicated	1.v. 表明（indicate的过去分词）；指出；显示 2.adj. 表明的；指示的 
hypocrisy	1.n. 虚伪；伪善 
Finns	1.n. 芬兰人（Finn的复数形式） 
sinking	1.n. 沉没 2.v. 下沉（sink的现在分词） 3.adj. 下沉的 
Bouteflika	
Munk	1.n. (Munk)人名；(英)芒克；(德、丹、匈、捷、塞、瑞典)蒙克 
laser	1.n. 激光 2.n. (Laser)人名；(德)拉泽 
MEPs	1.abbr. 最低能效标准（Minimum Energy Performance Standards）；海洋生态进程（Marine Ecology Progress Series） 
Faisal	1.n. 费萨尔（沙特阿拉伯国王） 
respite	1.n. 缓解；暂缓；暂时的休息；缓期执行 2.vt. 使缓解；使暂缓；使延期；缓期执行 
securitisation	1.n. 证券化 
fibre	1.n. 纤维；纤维制品 
Yanis	1.n. (Yanis)人名；(俄)亚尼斯 
Express	1.n. 快车，快递，专使；捷运公司 2.vt. 表达；快递 3.adj. 明确的；迅速的；专门的 
waged	1.v. 进行；开始（wage的过去分词） 2.adj. 有职业的；有工作的；支付工资的 
unequal	1.n. 不等同的事物 2.adj. 不平等的；不规则的；不胜任的 
universally	1.adv. 普遍地；人人；到处 
heal	1.vt. 治愈，痊愈；和解 2.vi. 痊愈 3.n. (Heal)人名；(英)希尔 
mired	1.v. 使…陷于泥泞，使…陷入困境（mire的过去式） 
royalties	1.n. 版税；稿酬（royalty的复数形式） 
sophistication	1.n. 复杂；诡辩；老于世故；有教养 
Farmers	1.n. [农] 农民（farmer的复数） 
evade	1.vt. 逃避；规避；逃脱 2.vi. 逃避；规避；逃脱 
nominee	1.n. 被任命者；被提名的人；代名人 
withstand	1.vt. 抵挡；禁得起；反抗 2.vi. 反抗 
diversification	1.n. 多样化；变化 
Yorkers	1.n. （板球）击球棒下面通过的球 
bewildering	1.adj. 使人困惑的；令人产生混乱的 2.v. 使迷惑（bewilder的ing形式） 
credit-rating	1.信用评级 
downgraded	1.v. 信用等级下降（downgrade的过去式） 2.adj. 降级的；受鄙视的 
Youth	1.n. 青年；青春；年轻；青少年时期 
devaluation	1.n. 货币贬值 
biotech	1.abbr. 生物技术；生物科技（biotechnology） 
motive	1.n. 动机，目的；主题 2.adj. 发动的；成为动机的 3.vt. 使产生动机，激起 
embroiled	1.adj. 卷入的；纠缠不清的 2.v. 卷入（embroil的过去式和过去分词）；牵连 
newish	1.adj. 尚新的；稍微新的 
manufacture	1.n. 制造；产品；制造业 2.vt. 制造；加工；捏造 3.vi. 制造 
exhausted	1.v. 耗尽；用尽；使…精疲力尽（exhaust的过去式） 2.adj. 疲惫的；耗尽的 
afloat	1.adj. 在海上的；飘浮的；浸满水的；在传播的 2.adv. 在海上；飘浮著；浸满水 
disadvantage	1.n. 缺点；不利条件；损失 
honesty	1.n. 诚实，正直 
cautiously	1.adv. 慎重地，谨慎地 
vegetables	1.n. [园艺] 蔬菜（vegetable的复数形式）；菜类 
dotted	1.v. 点缀（dot的过去分词）；布满；打点于 2.adj. 星罗棋布的；有点的 
chefs	
objected	1.n. 目标；物体；客体；宾语 2.vt. 提出…作为反对的理由 3.vi. 反对；拒绝 
growers	1.雏 
wealthier	1.富有的（wealthy的比较级） 
Pablo	1.n. 帕布鲁棕色 
auctions	1.n. [贸易] 拍卖（auction的复数） 2.v. [贸易] 拍卖（auction的三单形式） 
Yemeni	1.n. 也门人 2.adj. 也门的；也门人的 
purely	1.adv. 纯粹地；仅仅，只不过；完全地；贞淑地；清洁地 
voluntary	1.n. 志愿者；自愿行动 2.adj. 自愿的；志愿的；自发的；故意的 
denial	1.n. 否认；拒绝；节制；背弃 
deterrent	1.n. 威慑；妨碍物；挽留的事物 2.adj. 遏制的，威慑的；制止的 
much-needed	
Sinai	1.n. 西奈 
advertise	1.vt. 通知；为…做广告；使突出 2.vi. 做广告，登广告；作宣传 
rosy	1.adj. 蔷薇色的，玫瑰红色的；美好的；乐观的；涨红脸的 2.n. (Rosy)人名；(罗、意、瑞、典)罗茜(女名)，罗西；(英)罗茜 
battled	1.有雉堞的；有城垛的 
tainted	1.adj. 污染的；感染的 
orderly	1.n. 勤务兵；传令兵；护理员 2.adj. 有秩序的；整齐的；值班的 3.adv. 顺序地；依次地 
renegotiate	1.vt. 重新谈判；重新协商 2.vi. 重新谈判 
conciliatory	1.adj. 安抚的；调和的；调停的 
blanket	1.n. 毛毯，毯子；毯状物，覆盖层 2.adj. 总括的，全体的；没有限制的 3.vt. 覆盖，掩盖；用毯覆盖 
farewell	1.n. 告别，辞别；再见；再会 2.adj. 告别的 3.int. 别了！（常含有永别或不容易再见面的意思）；再会！ 
handy	1.adj. 便利的；手边的，就近的；容易取得的；敏捷的 2.n. (Handy)人名；(英)汉迪 
eve	1.n. 夏娃； 前夕；傍晚；重大事件关头 
trailing	1.n. 拖尾；泥浆彩饰 2.v. 尾随（trail的ing形式） 3.adj. 后面的；拖尾的；牵引的；被拖动的；蔓延的 
privileges	1.n. [计] 特权（privilege的复数） 2.v. 给与…特权（privilege的第三人称单数形式） 
prescriptions	1.n. 医药处方，[医] 药方（prescription复数形式） 
historically	1.adv. 历史上地；从历史观点上说 
differing	1.vt. 使…相异；使…不同 2.vi. 相异；意见分歧 3.n. (Differ)人名；(法)迪费 
poaching	1.n. 非法狩猎；物色人才；漂洗；低温煮 2.v. 把…踏成泥浆；非法猎取；漂洗；窃取（poach的ing形式） 
Executive	1.n. 总经理；执行委员会；执行者；经理主管人员 2.adj. 行政的；经营的；执行的，经营管理的 
Sanford	1.n. 桑福德（男子名） 
upside	1.n. 上部；上面；上边 
ladder	1.n. 阶梯；途径；梯状物 2.vt. 在……上装设梯子 3.vi. 成名；发迹 
alumni	1.n. 男校友；男毕业生（alumnus的复数） 
Ethnic	1.adj. 种族的；人种的 
prevailed	1.流行（ prevail的过去式和过去分词 ） 2.获胜（ prevail的过去式和过去分词 ） 
acquiring	1.n. 捕获，探测；习得；瞄准 2.v. 获得（acquire的ing形式） 
postpone	1.vt. 使…延期；把…放在次要地位；把…放在后面 2.vi. 延缓，延迟；延缓发作 
Fred	1.abbr. 快速随机询问显示（Fast Random Enquiry Display） 
launches	1.n. 汽艇（launch的复数） 2.v. [航] 发射；下水；投入（launch的单三形式） 
lags	1.n. 延迟支付进口货款；落后时间（lag的复数形式） 2.v. 落后于（lag的第三人称单数形式） 
payouts	1.n. 支出（payout的复数形式）；付款；花费 
tweaked	1.n. 扭；拧；焦急 2.vt. 扭；用力拉；开足马力 
wearable	1.n. 衣服 2.adj. 可穿用的，可佩带的；耐用的 
sponsor	1.n. 赞助者；主办者；保证人 2.vt. 赞助；发起 
Cash	1.n. 现款，现金 2.vt. 将…兑现；支付现款 3.n. (Cash)人名；(英)卡什 
cheating	1.n. 行骗，欺骗行为 2.adj. 欺骗的 
execute	1.vt. 实行；执行；处死 
feat	1.n. 功绩，壮举；技艺表演 2.adj. 合适的；灵巧的 
cracking	1.n. 破裂；分馏 2.v. 破裂；打开；变声（crack的ing形式） 3.adj. 重大的；敏捷的；出色的 4.adv. 非常；极其 
Guangzhou	1.n. 广州（广东省省会） 
repairing	1.v. 修复（repair的ing形式）；修理 
parallels	1.n. 平行线；平行状态；匹敌者（parallel的复数形式） 2.v. 使…成平行；与…相应（parallel的第三人称单数） 
appreciation	1.n. 欣赏，鉴别；增值；感谢 
indicate	1.vt. 表明；指出；预示；象征 
estates	1.n. 房地产，[经] 财产（estate的复数）；不动产 2.v. 赠（estate的三单形式）；使有地产 
dies	1.n. [机] 模具（名词die的复数）；（拉）日 2.v. 死亡；消失（动词die的第三人称单数形式）；凋谢 3.n. (Dies)人名；(英)戴斯；(西)迭斯 
lonely	1.n. 孤独者 2.adj. 寂寞的；偏僻的 
Yorkshire	1.n. 约克郡（英格兰东北的一郡） 
exposing	1.n. 遗弃；露体；陈列 2.v. 揭露；展览；遭遇（expose的ing形式） 
bishop	1.n. 主教 2.象 
veil	1.n. 面纱；面罩；遮蔽物；托词 2.vt. 遮蔽；掩饰；以面纱遮掩；用帷幕分隔 3.vi. 蒙上面纱；出现轻度灰雾 4.n. (Veil)人名；(法)韦伊；(德)法伊尔 
disappearance	1.n. 消失；不见 
complacency	1.n. 自满；满足；自鸣得意 
occupy	1.vt. 占据，占领；居住；使忙碌 
crave	1.vi. 渴望；恳求 2.vt. 渴望；恳求 3.n. (Crave)人名；(法)克拉夫 
cite	1.vt. 引用；传讯；想起；表彰 
greying	1.adj. 石墨化的；发灰色的 
riders	1.骑手 2.附文 3.扶手（rider的复数） 
incompetent	1.n. 无能力者 2.adj. 无能力的，不胜任的；不合适的；不适当的；无力的 
libertarian	1.n. 自由意志主义者；行动自由论者 2.adj. 自由的；自由论者的；持自由论的 
buoyed	1.[水运] 浮标 
appalling	1.adj. 可怕的；令人震惊的 2.v. 使惊愕；惊吓（appal的ing形式） 
ratified	1.adj. 批准的 2.vt. 批准（ratify的过去式） 
forgiven	1.vt. 原谅（forgive的过去分词） 
specially	1.adv. 特别地；专门地 
spied	1.v. 侦探，找出（spy的过去式） 
setbacks	1.n. 挫折；周折（setback复数） 
Bible	1.n. 有权威的书 
consists	1.v. 由…构成；由…组成（consist的三单形式） 
inspection	1.n. 视察，检查 
practise	1.vi. 练习，实践；实施，实行；从事 2.vt. 练习，实践；实施，实行 
mildly	1.adv. 温和地，和善地；适度地 
energetic	1.adj. 精力充沛的；积极的；有力的 
disliked	1.vt. 不喜欢，厌恶 2.n. 嫌恶，反感，不喜爱 
throne	1.n. 王座；君主；王权 2.vt. 使登王位 3.vi. 登上王座 4.n. (Throne)人名；(瑞典)特罗内；(英)特罗恩 
self-interest	1.n. 私利；利己主义 
rash	1.n. [皮肤] 皮疹；突然大量出现的事物 2.adj. 轻率的；鲁莽的；不顾后果的 3.n. (Rash)人名；(英、以、阿拉伯)拉什 
lax	1.n. 松元音；泻肚 2.adj. 松的；松懈的；腹泻的 3.n. (Lax)人名；(英、法、德、意、芬、匈、瑞典)拉克斯 
rebuilt	1.n. 重建 2.v. 重新组装（rebuild的过去式和过去分词） 
decentralisation	1.n. 地方分权；疏散（等于decentralization） 
antibodies	1.n. [免疫] 抗体（antibody的复数） 
radically	1.adv. 根本上；彻底地；以激进的方式 
squeezing	1.n. 压榨；推挤；挤出酌；轧水 2.v. 挤压；握住；硬塞进；紧抱；敲诈（squeeze的ing形式） 3.adj. 挤压的；压榨的 
guru	1.n. 古鲁（指印度教等宗教的宗师或领袖）；领袖；专家 2.n. (Guru)人名；(印)古鲁 
rethink	1.n. 重新考虑；反思；新想法 2.vt. 重新考虑；再想 3.vi. 重新考虑；再想 
stones	1.n. 石子（stone的复数）；小石头 2.v. 向…扔石子；用石块铺（stone的三单形式） 3.n. (Stones)人名；(英)斯通斯 
singer	1.n. 歌手，歌唱家 2.n. (Singer)人名；(英、德、瑞典、塞、罗、捷、葡、土)辛格；(法)桑热 
illustrates	1.v. 阐明；举例说明（illustrate的三单形式）；给…加插图 
Planet	1.n. 行星 2.n. (Planet)人名；(法)普拉内；(西、葡)普拉内特 
Fortunately	1.adv. 幸运地 
halfway	1.adj. 中途的；不彻底的 2.adv. 到一半；在中途 
galaxies	1.n. [天] 星系；银河系（galaxy的复数） 
adapted	1.v. 使适应，改编（adapt的过去式） 2.adj. 适合的 
Bang	1.n. 刘海；重击；突然巨响 2.vt. 重击；发巨响 3.adv. 直接地；砰然地；突然巨响地 4.n. (Bang)人名；(英、乍)班；(芬、德、丹)邦 
sciences	1.n. 科学（science的复数） 
soup	1.n. 汤，羹；马力 2.vt. 加速；增加马力 
operational	1.adj. 操作的；运作的 
flourished	1.n. 兴旺；茂盛；挥舞；炫耀；华饰 2.vt. 夸耀；挥舞 3.vi. 繁荣，兴旺；茂盛；活跃；处于旺盛时期 
restrained	1.v. 抑制；约束（restrain的过去分词） 2.adj. 克制的，受限制的；拘谨的 
Murphy	1.n. 马铃薯，土豆 2.n. (Murphy)人名；(英、葡、瑞典)墨菲 
damning	1.adj. 咒骂的；毁灭的；受永罚的 2.n. 诅咒 3.v. 咒骂（damn的ing形式） 
gases	1.n. 气体 2.煤气 3.毒气 4.用毒气杀死 5.汽油 
Yahoo	1.n. 粗鲁的人 
springs	1.n. 斯普林斯（南非东部城市名） 
Bogotá	
devout	1.adj. 虔诚的；衷心的 
wield	1.vt. 使用；行使；挥舞 
collectors	1.n. 收藏家；收集者；聚集剂；[电子] 集电极（collector的复数） 
inability	1.n. 无能力；无才能 
revelation	1.n. 启示；揭露；出乎意料的事；被揭露的真相 
overshadowed	1.vt. 使失色；使阴暗；遮阴；夺去…的光彩 
divert	1.vt. 转移；使…欢娱；使…转向 2.vi. 转移 3.n. (Divert)人名；(法)迪韦尔 
Kuroda	1.n. 日本黑田精工 
submarines	1.n. 潜艇；潜水艇（submarine的复数） 
liberalising	1.使自由化 
co-operating	1.v. 合作；协作（co-operate的ing形式） 
handsome	1.adj. （男子）英俊的；可观的；大方的，慷慨的；健美而端庄的 
emphasises	1.vt. （英）强调；加强…的语气（等于emphasize ） 
polluters	1.n. 污染者；污染源；污染物质 
retains	1.保持 
nationality	1.n. 国籍，国家；民族；部落 
defy	1.n. 挑战；对抗 2.vt. 藐视；公然反抗；挑衅；使落空 
rogue	1.n. 流氓；小淘气；凶猛的离群兽；（尤指植物的）劣种 2.adj. （野兽）凶猛的 3.vt. 欺诈；去劣 4.vi. 游手好闲；去劣；流浪 5.n. (Rogue)人名；(法)罗格 
Gulenists	
emphasise	1.vt. （英）强调；加强…的语气（等于emphasize ） 
alert	1.n. 警戒，警惕；警报 2.adj. 警惕的，警觉的；留心的 3.vt. 警告；使警觉，使意识到 4.n. (Alert)人名；(西)阿莱尔特 
fitness	1.n. 健康；适当；适合性 
expectation	1.n. 期待；预期；指望 
sequence	1.n. [数][计] 序列；顺序；续发事件 2.vt. 按顺序排好 
parity	1.n. 平价；同等；相等 
Strait	1.n. 海峡；困境 2.adj. 狭窄的；苦恼的 3.n. (Strait)人名；(英)斯特雷特 
haze	1.n. 阴霾；薄雾；疑惑 2.vt. 使变朦胧；使变糊涂 3.vi. 变朦胧；变糊涂 4.n. (Haze)人名；(法)阿泽 
closure	1.n. 关闭；终止，结束 2.vt. 使终止 
subprime	1.adj. 次级的；准最低贷款利率的 
Merck	1.n. 默克公司（财富500强公司之一，部所在地美国，主要经营制药） 
firepower	1.n. 火力 
outpost	1.n. 前哨；警戒部队；边区村落 
Ricardo	1.n. 里卡多（姓氏） 
jazz	1.n. 爵士乐，爵士舞；喧闹 2.vi. 奏爵士乐，跳爵士舞；游荡 3.vt. 奏爵士乐；使活泼 4.adj. 爵士乐的；喧吵的 5.n. (Jazz)人名；(德)雅茨 
cousins	1.n. 卡曾斯（姓） 
connecting	1.n. 连接；管接头，套管 2.v. 连接（connect的ing形式） 3.adj. [计] 连接的 
barring	1.prep. 除非；不包括；除…以外 2.v. 阻拦（bar的ing形式） 3.n. (Barring)人名；(德)巴林 
loosening	1.n. 松散，放松 2.v. 使…松开（loosen的ing形式） 
reshape	1.vt. 改造；再成形 
pin	1.n. 大头针，别针，针；栓；琐碎物 2.vt. 钉住；压住；将……用针别住 
fretted	1.adj. 焦躁的；腐蚀的；附有弦马的 2.v. 烦躁；侵蚀；耗损（fret的过去分词） 
drain	1.n. 排水；下水道，排水管；消耗 2.vt. 喝光，耗尽；使流出；排掉水 3.vi. 排水；流干 4.n. (Drain)人名；(英)德雷恩；(法)德兰 
proposing	1.v. 提议（propose的现在分词）；求婚 
militarily	1.adv. 在军事上；从军事角度；以武力；以军事行动 
broaden	1.vt. 使扩大；使变宽 2.vi. 扩大，变阔；变宽，加宽 
celebrations	1.n. 庆典，庆祝会；庆祝；颂扬 
cracked	1.v. 破裂；崩溃（crack的过去分词）；发沙哑声；失败 2.adj. 破裂的；声音嘶哑的；精神失常的 
tweet	1.n. 小鸟叫声；自录音再现装置发出的高音；推特 2.vi. 吱吱地叫；啾鸣 
casts	1.n. 演员阵容；[生理] 管型（cast的复数） 2.v. 投（cast的三单形式） 
touted	1.v. 招来顾客（tout过去式） 2.adj. 被吹捧的 
highs	1.adj. 高的；高级的；崇高的；高音调的 2.n. 高水平；天空；由麻醉品引起的快感；高压地带 3.adv. 高；奢侈地 4.n. (High)人名；(英)海伊 
bestselling	1.adj. 畅销的 
Chengdu	1.n. 成都市（中国四川省省会） 
assist	1.n. 帮助；助攻 2.vi. 参加；出席 3.vt. 帮助；促进 
protectionist	1.n. 贸易保护主义者 2.adj. 贸易保护主义的；保护贸易论的 
Latvia	1.n. 拉脱维亚 
myself	1.pron. 我自己；我亲自；我的正常的健康状况和正常情绪 
Spending	1.n. 花费；开销 2.v. 花费；度过（spend的现在分词形式） 
Rand	1.n. 兰特（南非的货币单位）；边缘；垫皮，衬底（鞋后根与鞋底中间的） 2.n. (Rand)人名；(英、德、俄、瑞典)兰德 
Years	1.n. [天] 年；年龄；岁月；年代 
AAP	1.abbr. 阿波罗应用计划（Apollo Applications Program）；美国出版商协会（Association of American Publishers） 
concession	1.n. 让步；特许（权）；承认；退位 
ruin	1.n. 废墟；毁坏；灭亡 2.vt. 毁灭；使破产 3.vi. 破产；堕落；被毁灭 4.n. (Ruin)人名；(德、意、芬)鲁因；(法)吕安 
endangered	1.adj. 濒临灭绝的；有生命危险的 
Senegal	1.n. 塞内加尔（非洲国家） 
flavour	1.n. 香味；滋味 2.vt. 给……调味；给……增添风趣 
Common	1.n. 普通；平民；公有地 2.adj. 共同的；普通的；一般的；通常的 3.n. (Common)人名；(法)科蒙；(英)康芒 
Sogaz	
derived	1.v. 得到；推断（derive的过去分词）；由…而来 2.adj. 导出的；衍生的，派生的 
Culture	1.n. 文化，文明；修养；栽培 2.vt. [细胞][微] 培养（等于cultivate） 
inject	1.vt. 注入；注射 
contend	1.vi. 竞争；奋斗；斗争；争论 2.vt. 主张；为...斗争 
satisfied	1.v. 使满意（satisfy的过去式） 2.adj. 感到满意的 
Hebdo	
plight	1.n. 困境；境况；誓约 2.vt. 保证；约定 
environmentalist	1.n. 环保人士；环境论者；研究环境问题的专家 
eruptions	1.n. 火山爆发；出疹（eruption的复数形式） 
Kadyrov	1.n. (Kadyrov)人名；(俄)卡德罗夫 
Yangon	1.n. 仰光（缅甸首都，等于Rangoon） 
outweigh	1.vt. 比…重（在重量上）；比…重要；比…有价值 
preliminary	1.n. 准备；预赛；初步措施 2.adj. 初步的；开始的；预备的 
essay	1.n. 散文；试图；随笔 2.vt. 尝试；对…做试验 
emphasised	1.vt. （英）强调；加强…的语气（等于emphasize ） 
lag	1.n. 落后；迟延；防护套；囚犯；桶板 2.adj. 最后的 3.vi. 滞后；缓缓而行；蹒跚 4.vt. 落后于；押往监狱；加上外套 5.n. (Lag)人名；(俄)拉格 
needles	1.n. 针数，千针本；[印刷] 折页顶针（needle复数形式） 2.n. (Needles)人名；(英)尼德尔斯 
Saud	1.n. 沙特（人名） 
absurd	1.n. 荒诞；荒诞作品 2.adj. 荒谬的；可笑的 
Hathaway	1.n. 哈撒韦（衬衫品牌）；海瑟薇（人名） 
sterling	1.n. 英国货币；标准纯银 2.adj. 纯正的；英币的；纯银制的 3.n. (Sterling)人名；(德)施特林；(英、西、瑞典)斯特林 
BlackRock	1.n. 黑石集团（美国一家债券基金管理公司） 
stump	1.vt. 砍伐；使为难；在…作巡回政治演说 2.n. 树桩；残余部分；假肢 3.vi. 笨重地行走；发表竞选演说 4.n. (Stump)人名；(英)斯顿普；(德)施通普 
photography	1.n. 摄影；摄影术 
buck	1.n. （美）钱，元；雄鹿；纨绔子弟；年轻的印第安人或黑人 2.n. (Buck)人名；(英、西)巴克；(法)比克；(德、瑞典、匈)布克 
referendums	1.n. 投票，公投（referendum复数） 
litigation	1.n. 诉讼；起诉 
splurge	1.n. 挥霍；炫耀 2.vt. 挥霍；夸耀 3.vi. 挥霍；卖弄 
Adobe	1.n. 土砖，砖坯 
Carta	
Tambora	
Friends	1.n. 朋友( friend的名词复数 ) 
Horizon	1.n. [天] 地平线；视野；眼界；范围 
Resources	1.n. [计][环境] 资源；物力（resource的复数） 2.v. 向…提供资金（resource的第三人称单数） 
slowest	1.adj. 最慢的（slow的最高级） 
projection	1.n. 投射；规划；突出；发射；推测 
topple	1.vt. 推翻；颠覆；使倒塌 2.vi. 倾倒；倒塌；摇摇欲坠 3.n. (Topple)人名；(英)托佩尔 
inputs	1.n. [自][电子] 输入；投入（input的复数） 
splitting	1.v. 裂开（split的现在分词） 2.adj. 极快的；爆裂似的，剧烈的；滑稽的 
cognitive	1.adj. 认知的，认识的 
tinkering	1.n. 铸补，熔补 2.v. 做焊锅匠，笨拙的修补（tinker的现在分词形式） 
psychology	1.n. 心理学；心理状态 
deepening	1.n. 加深，延深；向下侵蚀 2.v. 使深化；加深（deepen的现在分词） 
packaged	1.v. 包装；把…装袋（package的过去式和过去分词） 2.adj. 包装过的 
notwithstanding	1.conj. 虽然 2.prep. 尽管，虽然 3.adv. 尽管，仍然 
proceed	1.vi. 开始；继续进行；发生；行进 
Captain	1.n. 队长，首领；船长；上尉；海军上校 2.vt. 指挥；率领 
physically	1.adv. 身体上，身体上地 
Jennifer	1.n. 詹尼弗（女子名） 
consideration	1.n. 考虑；原因；关心；报酬 
bully	1.n. 欺凌弱小者；土霸 2.vt. 欺负；威吓 3.adj. 第一流的；特好的 4.vi. 欺侮人 5.adv. 很；十分 6.int. 好；妙 7.n. (Bully)人名；(法)布利 
violating	1.v. 违背，违反（violate的现在分词） 
protections	1.n. 保护（protection的复数）；保护动作 
culprit	1.n. 犯人，罪犯；被控犯罪的人 
thaw	1.n. 解冻；融雪 2.vt. 使融解；使变得不拘束 3.vi. 融解；变暖和 4.n. (Thaw)人名；(缅)陶 
Morris	1.n. （打扮成 Robin Hood 等传奇人物跳的）莫理斯舞 2.n. (Morris)人名；(丹、德、法、捷、葡、西、意、英)莫里斯 
Rafael	1.n. 拉斐尔（男子名，来源于圣经故事） 
absolutely	1.adv. 绝对地；完全地 
consisted	1.vi. 组成；在于；符合 
tribunal	1.n. 法庭；裁决；法官席 
dismantling	1.n. 解散；（枪支）分解 2.v. 拆除；废除（dismantle的ing形式） 
cough	1.n. 咳嗽，咳嗽声；咳嗽病 2.vt. 咳出 3.vi. 咳嗽 4.n. (Cough)人名；(英)考夫 
bonanza	1.n. 富矿带；带来好运之事；幸运 
painfully	1.adv. 痛苦地，费力地 
venues	1.n. 场地，场馆（venue复数形式）；犯罪现场，发生地点 
embassies	1.n. 大使馆；大使馆全体人员 
Julius	1.n. 朱利叶斯（男子名） 
shells	1.n. 贝壳（shell的复数） 2.v. 脱壳（shell的第三人称单数形式） 
terribly	1.adv. 非常；可怕地；极度地 
glasses	1.n. [轻] 眼镜；玻璃（glass的复数形式）；双筒望远镜 2.v. 把…装入玻璃容器内；给…装上玻璃（glass的第三人称单数形式） 
wisely	1.adv. 明智地；聪明地；精明地 2.n. (Wisely)人名；(英)怀斯利 
philosopher	1.n. 哲学家；哲人 
fishermen	1.n. 渔夫；渔船（fisherman的复数形式） 
metro	1.n. 地铁；大都市；伦敦地下铁道；麦德隆（财富500强公司之一，总部所在地德国，主要经营零售） 
excellence	1.n. 优秀；美德；长处 
retreated	1.v. 撤退；隐退（retreat的过去式及过去分词） 
daylight	1.n. 白天；日光；黎明；公开 
rump	1.n. （人的）臀部，（动物的）尾部；残余，渣滓 2.n. (Rump)人名；(法、罗、德)伦普 
inserted	1.adj. 插入的；[生物] 嵌入的；著生的；附着的 
interpreted	1.v. 解释；解读（interpret的过去分词形式）；口译 
pointless	1.adj. 无意义的；钝的；不尖的；不得要领的 
imply	1.vt. 意味；暗示；隐含 
upheld	1.v. 支持（uphold的过去式） 
secretive	1.adj. 秘密的；偷偷摸摸的；促进分泌的 
Conservative-led	
discouraged	1.v. 劝阻（discourage的过去分词）；使失去勇气 2.adj. 气馁的 
Unilever	1.n. 联合利华（财富500强公司之一，总部位于荷兰和英国，主要经营食品） 
York-based	
Director	1.n. 主任，主管；导演；人事助理 2.n. (Director)人名；(英)迪雷克托 
uneasy	1.adj. 不舒服的；心神不安的；不稳定的 
Guardian	1.n. [法] 监护人，保护人；守护者 2.adj. 守护的 3.n. (Guardian)人名；(西)瓜尔迪安 
public-relations	
Brasília	
recruiters	1.n. 招聘人员，征兵人员 
situations	1.n. 状况；情境；局面（situation的复数形式） 
disguise	1.n. 伪装；假装；用作伪装的东西 2.vt. 掩饰；假装；隐瞒 
supervision	1.n. 监督，管理 
Light	1.n. 光；光线；灯；打火机；领悟；浅色；天窗 2.adj. 轻的；浅色的；明亮的；轻松的；容易的；清淡的 3.vt. 照亮；点燃；着火 4.vi. 点着；变亮；着火 5.adv. 轻地；清楚地；轻便地 6.n. (Light)人名；(英)莱特 
electrons	1.n. [物] 电子（electron的复数形式） 
manned	1.v. 给…配备人员（man的过去分词） 2.adj. 有人驾驶的；有人操纵的；配备齐船员的 
plutonium	1.n. [化学] 钚（94号元素） 
vivid	1.adj. 生动的；鲜明的；鲜艳的 
discoveries	1.n. 发现（discovery的复数） 
autobiography	1.n. 自传；自传文学 
defected	1.[晶体][材] 缺陷 
adventure	1.n. 冒险；冒险精神；投机活动 2.vt. 冒险；大胆说出 3.vi. 冒险 
Alps	1.n. 阿尔卑斯山脉 
motorists	1.汽车司机 2.乘汽车旅行者（ motorist的名词复数 ） 
Anderson	1.n. 安德森（男子名）；安德森市（美国印第安纳州） 
franc	1.n. 法郎 2.法郎体系 
thinkers	1.n. 思想者；善于思考的人（thinker的复数形式） 
discouraging	1.v. 沮丧（discourage的ing形式）；失去勇气 2.adj. 使人沮丧的；令人气馁的 
stubbornly	1.adv. 顽固地；倔强地 
manufactured	1.v. 制造，加工（manufacture的过去式） 2.adj. 制造的，已制成的 
Nomura	1.n. 野村（日本企业）；野村证券 
budgetary	1.adj. 预算的 
subsidise	1.vt. 资助（等于subsidize）；给...补助金 2.vi. 消退；下沉；平息 
cling	1.vi. 坚持，墨守；紧贴；附着 
seasoned	1.adj. 经验丰富的；老练的；调过味的 
amendments	1.n. 修正（amendment的复数）；修正案 
Chamber	1.n. （身体或器官内的）室，膛；房间；会所 2.adj. 室内的；私人的，秘密的 3.vt. 把…关在室内；装填（弹药等） 4.n. (Chamber)人名；(英)钱伯 
unaffordable	1.adj. 买不起的 
primaries	1.n. 基元；主翼羽，比较原色（primary复数） 
Kaiser	1.n. （德国）皇帝 
databases	1.n. [计] 数据库；资料库（database的复数） 2.v. 把信息存入数据库（database的第三人称单数） 
wooing	1.vt. 追求；招致；向…求爱；恳求 2.vi. 求爱；恳求 
Mississippi	1.n. 密西西比河（美国河流，世界上最大的河流之一）；密西西比州（美国州名） 
strip	1.n. 带；条状；脱衣舞 2.vt. 剥夺；剥去；脱去衣服 3.vi. 脱去衣服 
abused	1.n. 滥用，恶习；受虐 2.v. 滥用；虐待；辱骂（abuse的过去分词） 
visitor	1.n. 访问者，参观者；视察者；候鸟 
Zuckerberg	1.扎克伯格 
witnesses	1.n. [法] 证人；目击者；[法] 证据（witness的复数） 2.v. 作证；目睹（witness的三单形式） 
dragging	1.adj. 拖延的；拖曳用的 2.vt. 牵引（drag的现在分词） 
Leung	1.梁/亮；莱翁 2.n. (Leung)人名；(西)莱昂 
overblown	1.adj. 停息的；过分的；已盛开过的 2.v. 吹散；用力吹；过分渲染（overblow的过去分词） 
reviled	1.vt. 辱骂；斥责 2.vi. 辱骂；谩骂 
hardened	1.adj. 变硬的；坚定的 2.v. 坚定，变硬（harden的过去分词） 
xenophobic	1.adj. 恐惧外国人的 
grumbles	1.vi. 抱怨；嘟囔 2.n. 怨言 3.vt. 喃喃地说出 4.adj. 抱怨地表示；嘟囔地说 
fold	1.n. 折痕；信徒；羊栏 2.vt. 折叠；合拢；抱住；笼罩 3.vi. 折叠起来；彻底失败 
bursting	1.v. 爆炸；猛然打开；突然开始（burst的ing形式） 2.adj. 充满的；渴望的 
Statistics	1.n. 统计；统计学；[统计] 统计资料 
deadlock	1.n. 僵局，停顿 2.vt. 停顿；相持不下 3.vi. 死锁；停顿 
probable	1.n. 很可能的事；大有希望的候选者 2.adj. 很可能的；可信的 
toilet	1.n. 厕所，盥洗室；梳妆，打扮 2.vt. 给…梳妆打扮 3.vi. 梳妆，打扮 
franchise	1.n. 特权；公民权；经销权；管辖权 2.vt. 给…以特许（或特权）；赋予公民权 
Franklin	1.n. 小地主；乡绅 
installing	1.n. 安装；插入；任命 2.adj. 安装的 3.v. 安装；安置（install的ing形式）；正式任命 
untouched	1.adj. 未受影响的；未改变的；未触动过的；不受感动的 
fertiliser	1.n. 化肥（等于fertilizer） 
glamorous	1.adj. 迷人的，富有魅力的 
subdued	1.v. 使服从，压制，减弱（subdue 的过去式和过去分词） 2.adj. 减弱的；被制服的；被抑制的 
signalling	1.n. 信号传输法；发信号 
Breaking	1.n. 破坏；阻断 2.v. 破坏（break的ing形式） 
astronomers	1.天文学家 
atomic	1.adj. 原子的，原子能的；微粒子的 
enhanced	1.v. 提高；加强（enhance的过去分词） 2.adj. 加强的；增大的 
creditor	1.n. 债权人，贷方 
performers	1.n. 表演者；执行者（performer的复数形式） 
depicting	1.描绘 
Branfman	
unofficial	1.adj. 非官方的；非正式的 
wide-ranging	1.adj. 广泛的 
Stock	1.n. 股份，股票；库存；血统；树干 2.adj. 存货的，常备的；平凡的 3.vt. 进货；备有；装把手于… 4.vi. 囤积；办货；出新芽 5.n. (Stock)人名；(德、匈、捷)施托克；(英、法、葡、瑞典)斯托克 
assaults	1.n. 攻击（assault的复数） 2.vt. 攻击；袭击（assault的第三人称单数） 
irrational	1.n. [数] 无理数 2.adj. 不合理的；无理性的；荒谬的 
hawk	1.n. 鹰；鹰派成员；掠夺他人的人 2.vi. 清嗓；咳嗽；像鹰一般地袭击 3.vt. 兜售，沿街叫卖；捕捉；咳出 4.n. (Hawk)人名；(英)霍克；(西)奥克 
inclusion	1.n. 包含；内含物 
beneficial	1.adj. 有益的，有利的；可享利益的 
Tanzania	1.n. 坦桑尼亚（东非国家） 
McCain	1.n. 麦凯恩（美国共和党议员）；麦凯恩（姓氏） 
trimmed	1.adj. 平衡的；切边；纵倾的；修整过的 
Insurance	1.n. 保险；保险费；保险契约；赔偿金 
oblige	1.vt. 迫使；强制；赐，施恩惠；责成 2.vi. 帮忙；施恩惠 
mistaken	1.v. 弄错（mistake的过去分词） 2.adj. 错误的；弄错的；被误解的 
Mass	1.n. 块，团；群众，民众；大量，众多；质量 2.adj. 群众的，民众的；大规模的，集中的 3.vt. 使集合 4.vi. 聚集起来，聚集 
knocking	1.n. 爆震音；卡答卡答的故障声音 2.v. 敲（knock的ing形式） 
disarray	1.n. 无秩序；杂乱；衣冠不整 2.vt. 使混乱；弄乱；使脱去衣服 
advancing	1.v. 前进；超前（advance的ing形式） 2.adj. 前进的；年长的 
plotting	1.n. 测绘；标图 2.v. [测] 绘图；密谋（plot的ing形式） 
high-ranking	1.adj. 职位高的；阶级高的 
hawk	1.n. 鹰；鹰派成员；掠夺他人的人 2.vi. 清嗓；咳嗽；像鹰一般地袭击 3.vt. 兜售，沿街叫卖；捕捉；咳出 4.n. (Hawk)人名；(英)霍克；(西)奥克 
sucked	1.v. 吸，吮；吸收；吞没（suck的过去分词） 
Strip	1.n. 带；条状；脱衣舞 2.vt. 剥夺；剥去；脱去衣服 3.vi. 脱去衣服 
Arabian	1.n. 阿拉伯人 2.adj. 阿拉伯的；阿拉伯人的 
renew	1.vt. 使更新；续借；复兴；重申 2.vi. 更新；重新开始 
protagonist	1.n. 主角，主演；主要人物，领导者 
jittery	1.adj. 神经过敏的；战战兢兢的；紧张不安的 
outdoor	1.adj. 户外的；露天的；野外的（等于out-of-door） 
hard-up	1.adj. 缺钱，手头紧 
cheering	1.n. 欢呼；喝彩 2.adj. 令人高兴的 3.v. 欢呼（cheer的ing形式） 
ammunition	1.n. 弹药；军火 2.vt. 装弹药于 3.vi. 装弹药 
plethora	1.n. 过多；过剩；[医] 多血症 
chilly	1.adj. 寒冷的；怕冷的 2.n. (Chilly)人名；(法)希伊 
monuments	1.n. 遗迹；纪念物；不朽的功业；有永久价值的作品（monument的复数形式） 
MARCH	1.vi. （坚定地向某地）前进；行军，进军；游行示威；进展，进行 2.n. 行进，前进；行军；游行示威；进行曲 3.vt. 使前进；使行军 
unreported	1.adj. 未经报道的；未报告的 
Especially	1.adv. 特别；尤其；格外 
snatch	1.n. 抢夺；抓举；小量 2.vt. 夺得；抽空做；及时救助 3.vi. 抢走；很快接受 
doubles	1.n. 双打；[矿业] 双粒级煤；复制品（double的复数） 2.v. 使加倍；复制；折叠（double的三单形式） 3.n. (Doubles)人名；(英)道布尔斯 
chlorine	1.n. [化学] 氯（17号化学元素） 
chafe	1.n. 擦伤；气恼 2.n. (Chafe)人名；(尼日利)沙费；(英)蔡菲 3.vt. 擦破；擦热；擦痛；激怒 4.vi. 擦伤；磨擦；激怒 
uphill	1.n. 上升；登高 2.adj. 上坡的，向上的 3.adv. 向上地；往上坡 
sacks	1.麻布袋 2.n. (Sacks)人名；(英、西)萨克斯 
Revenues	1.n. [会计] 收入；税收；[会计] 收益；营业收入（revenue的复数形式） 
self-inflicted	1.adj. 自己造成的；加于自身的 
Energiewende	
overtime	1.n. [劳经] 加班时间；延长时间；加时赛 2.adj. 超时的；加班的 3.vt. 使超过时间 4.adv. 加班地 
ultra-low	1.超低的 
Production	1.n. 成果；产品；生产；作品 
Holdings	1.n. 占有的财产；所持股份 
Zone	1.n. 地带；地区；联防 2.vt. 使分成地带；环绕 3.vi. 分成区 4.n. (Zone)人名；(塞)佐内 
churning	1.n. 搅乳；一次提制的奶油 2.v. 搅拌（churn的ing形式） 
workforces	1.n. 劳动力；工人总数，职工总数 
entries	1.n. 进入；（词典所列的）词目（entry的复数形式） 
Infosys	1.n. 印孚瑟斯（印度历史上第一家在美国上市的公司） 
subscribe	1.vt. 签署；赞成；捐助 2.vi. 订阅；捐款；认购；赞成；签署 
intermediary	1.n. 中间人；仲裁者；调解者；媒介物 2.adj. 中间的；媒介的；中途的 
Normally	1.adv. 正常地；通常地，一般地 
insure	1.vt. 确保，保证；给…保险 2.vi. 确保；投保 
pogroms	1.vt. 对…大屠杀 2.n. 大屠杀 
Rhine	1.n. 莱茵河（位于欧洲西部） 
accumulating	1.n. [数] 累加 2.v. 积累（accumulate的ing形式） 
glimmer	1.n. 微光；闪光；少许 2.vi. 闪烁；发微光 
choke	1.n. 窒息；噎；[动力] 阻气门 2.vi. 窒息；阻塞；说不出话来 3.vt. 呛；使窒息；阻塞；抑制；扑灭 
phenomena	1.n. 现象（phenomenon 的复数 ） 
Presumably	1.adv. 大概；推测起来；可假定 
Kepler	1.n. 开普勒（德国天文学家，物理学家，开普勒定律的发现者）；开普勒环形山（在月球东北象限，直径为35公里） 
illuminating	1.adj. 照亮的，照明的；启蒙的，有启发性的 2.v. 照明，阐释（illuminate的现在分词形式） 
built-in	1.n. 内置 2.adj. 嵌入的；固定的 
decidedly	1.adv. 果断地；断然地；明显；毫无疑问 
tunes	1.调整 2.协调 3.n. (Tunes)人名；(葡)图内斯 
buttons	1.n. [电] 按钮（button的复数形式）；纽扣 
ebbed	1.n. 衰退；退潮；衰落 2.vi. 衰退；减少；衰落；潮退 
emigrated	1.vi. 移居；移居外国 2.vt. 移民 
ponds	1.n. [水文] 池塘（pond的复数） 2.v. 堵成池；筑成池塘（pond的三单形式） 3.n. (Ponds)人名；(英)庞兹 
Auschwitz	1.n. 奥许维次（波兰城市名） 2.n. (Auschwitz)人名；(德)奥施维茨 
sketches	1.n. [测] 草图；示意图；草图法（sketch的复数） 2.v. 素描，写生（sketch的第三人称单数） 
stabbed	1.v. 刺伤（stab的过去式和过去分词）；刺穿 
nurse	1.n. 护士；奶妈，保姆 2.vt. 看护，护理；照顾；培养；给…喂奶 3.vi. 照料，护理；喂奶；当保姆 4.n. (Nurse)人名；(英)纳斯 
hobble	1.n. 跛行步态 2.vt. 使跛行 3.vi. 蹒跚；跛行 
seething	1.v. 浸透；煮沸；激动（seethe的ing形式） 2.adj. 火热的，沸腾的 
hryvnia	1.格里夫尼亚（乌克兰的货币单位） 
nadir	1.n. 最低点，最底点；[天] 天底 2.n. (Nadir)人名；(土、葡、巴基、阿拉伯)纳迪尔 
measly	1.adj. 患麻疹的；极少的；低贱的 
Country	1.n. 国家，国土；国民；乡下，农村；乡村；故乡 2.adj. 祖国的，故乡的；地方的，乡村的；国家的；粗鲁的；乡村音乐的 
imaginative	1.adj. 虚构的；富于想像的；有创造力的 
Equality	1.n. 平等；相等；[数] 等式 
injustices	1.n. 不公正；不讲道义 
Guards	1.n. 守卫；后卫（guard的复数形式）；护卫队；禁卫军 2.v. 守卫；看守（guard的第三人称单数） 
electronically	1.adv. 电子地 
telephony	1.n. 电话（学）；电话制造 
pronouncements	1.n. 声明；宣告；公告；判决 
nominees	1.n. 被提名者，被指定人 
manoeuvre	1.n. 策略（等于maneuvre） 2.vt. 诱使；操纵；耍花招 3.vi. 调动；演习；用策略 
constitute	1.vt. 组成，构成；建立；任命 
Elena	1.n. 埃琳娜（女子名，等于Helen） 
standstill	1.n. 停顿；停止 
Unhappy	1.adj. 不快乐的；不幸福的；不适当的 
Reformation	1.n. 革新；改善 
legislator	1.n. 立法者 
Protestantism	1.n. 新教；新教教义；新教徒 
pastors	1.n. 牧师 2.vt. 作……的牧师 3.n. (Pastor)人名；(法、意、塞、葡、罗、捷、瑞典、德、西)帕斯托尔；(英)帕斯特 
marketers	1.n. 卖主；市场营销者（marketer的复数） 
evangelicals	1.n. 福音派（evangelical的复数形式） 
derail	1.n. 脱轨；[铁路] 脱轨器 2.vt. 使出轨 3.vi. 出轨 
sideways	1.adj. 向侧面的；一旁的 2.adv. 向侧面地；向一旁 
awarding	1.n. 颁奖（award的现在时，动名词形式）；获奖情况 
breakthroughs	1.突破 
adaptable	1.adj. 适合的；能适应的；可修改的 
Mohammad	1.n. 穆罕默德（穆斯林真主）；（阿拉伯）穆罕默德（男子名） 
year-long	1.长达一年的，一年之久的 
aggressively	1.adv. 侵略地；攻击地；有闯劲地 
federalist	1.adj. （支持）联邦党人的；联邦制的 2.n. 联邦党；联邦制拥护者；支持北部联邦者 
accords	
Dialogue	1.n. 对话；意见交换 2.vt. 用对话表达 3.vi. 对话 
zealots	1.n. 狂热者（zealot的复数）；奋锐党人 
underpins	1.vt. 巩固；支持；从下面支撑；加强…的基础 
dilute	1.vt. 稀释；冲淡；削弱 2.adj. 稀释的；淡的 3.vi. 变稀薄；变淡 
airtime	1.n. 电影或电视节目开始的时间 
Somalis	1.索马里人（Somali的复数） 
Fraser	1.n. 弗雷泽（男子名）；弗雷则河（加拿大西南部河流） 
Emmanuel	1.n. 以马内利（耶稣基督的别称）；伊曼纽尔（男子名，等于Immanuel） 
prosecuting	1.v. 起诉；进行（prosecute的ing形式）；实行 
Progressives	1.n. 进步派；进步人士（progressive的复数形式）；进步论者 
whale	1.n. 鲸；巨大的东西 2.vt. 猛揍；使惨败 3.vi. 捕鲸 4.n. (Whale)人名；(英)惠尔 
coercion	1.n. 强制；强迫；高压政治；威压 
dragon	1.n. 龙；凶暴的人，凶恶的人；严厉而有警觉性的女人 2.n. (Dragon)人名；(匈)德劳贡；(英、法、芬、罗、匈)德拉贡 
apiece	1.adv. 每人；每个；各自地 
garment	1.n. 衣服，服装；外表，外观 2.vt. 给…穿衣服 3.n. (Garment)人名；(英)加门特 
IDB	1.abbr. 工业开发委员会（Industrial Development Board）；智能数据库（intelligent database）；工业发展公债（industrial development bond）；美洲开发银行（Inter-American Development Bank） 
lopsided	1.adj. 不平衡的，倾向一方的 
Based	1.v. 立基于，以…为基础（base的过去式和过去分词） 2.adj. 有根基的 
fulfilled	1.v. 实现（fulfill的过去分词）；履行；满足 2.adj. 满足的；十分愉快的 
plugged	1.v. 堵塞；接通电源（plug的过去分词） 2.adj. 堵塞的；塞紧的 
swaggering	1.adj. 大摇大摆的 2.vt. 吹牛；神气活现；昂首阔步（swagger的现在分词） 3.vi. 威吓；吓唬（swagger的现在分词） 
swapping	1.n. 交换；调动 2.v. 交换（swap的ing形式） 
humility	1.n. 谦卑，谦逊 
Botox	1.n. 肉毒杆菌；肉毒杆菌毒素；肉毒杆菌毒素制剂；波托克斯 
headwinds	1.n. 逆风；顶头风 
Witness	1.n. 证人；目击者；证据 2.vt. 目击；证明；为…作证 3.vi. 作证人 4.n. (Witness)人名；(津)威特尼斯 
auditor	1.n. 审计员；听者；旁听生 
prudence	1.n. 审慎 
maturing	1.n. 老化；成熟酌；（陶瓷的）烧成 2.v. 成熟（mature的ing形式）；到期 
Santo	1.n. 圣者像；圣者 2.adj. 神圣的 
hindsight	1.n. 后见之明；枪的照门 
Jupiter	1.n. [天] 木星；朱庇特（罗马神话中的宙斯神） 
moons	1.n. [天] 月亮；月状物；月份；人造地球卫星（moon的复数） 2.v. 闲逛；呆想；像月亮般发光（moon的三单形式） 
comets	1.n. [天] 彗星（comet的复数） 2.n. (Comets)人名；(法)科梅 
tremors	1.n. 震动；颤抖（tremor的复数） 2.v. [物] 颤动（tremor的三单形式） 
modification	1.n. 修改，修正；改变 
fascinated	1.v. 使着迷；使陶醉（fascinate的过去分词） 2.adj. 着迷的；被深深吸引的 
awe	1.n. 敬畏 2.vt. 使敬畏；使畏怯 3.n. (Awe)人名；(德)阿韦 
Villa	1.n. 别墅；郊区住宅 2.n. (Villa)人名；(西)比利亚；(英、法、葡、罗、意、芬、刚、瑞典)维拉 
originated	1.v. 起源，发起；发明（originate的过去式，过去分词）；准备呼叫 
fairy	1.n. 仙女，小精灵；漂亮姑娘 2.adj. 仙女的 
singular	1.n. 单数 2.adj. 单数的；单一的；非凡的；异常的 
Davies	1.n. 戴维斯（男子名） 
sculpture	1.n. 雕塑；雕刻；刻蚀 2.vt. 雕塑；雕刻；刻蚀 3.vi. 从事雕刻 
procession	1.n. 队伍，行列；一列，一排；列队行进 2.vt. 沿著……行进 3.vi. 列队行进 
stocked	1.n. 股份，股票；库存；血统；树干 2.adj. 存货的，常备的；平凡的 3.vt. 进货；备有；装把手于… 4.vi. 囤积；办货；出新芽 5.n. (Stock)人名；(德、匈、捷)施托克；(英、法、葡、瑞典)斯托克 
Pyongyang	1.n. 平壤（朝鲜民主主义人民共和国首都） 
laggards	1.n. 落后者；迟滞者（laggard的复数） 
residual	1.n. 剩余；残渣 2.adj. 剩余的；残留的 
Planck	1.n. 普朗克（德国物理学家） 
Founded	1.v. 建立（found的过去分词）；创立 2.adj. 有基础的 
Lyft	
Aside	1.prep. 在…旁边 2.n. 旁白；私语，悄悄话；离题的话 3.adv. 离开，撇开；在旁边 
millionaires	1.n. [经] 百万富翁（millionaire的复数形式） 
jailing	1.n. 监狱；监牢；拘留所 2.vt. 监禁；下狱 3.n. (Jail)人名；(英)杰尔 
to-do	1.n. 要办的事；骚乱；大惊小怪 
complying	
ferries	1.n. 渡轮；摆渡（ferry的复数） 2.v. 渡运；运送；摆渡（ferry的第三人称单数） 3.n. (Ferries)人名；(英)费里斯 
inflammatory	
Shipping	1.n. [船] 船舶，船舶吨数；海运；运送 2.v. 运送，乘船（ship的ing形式） 3.n. (Shipping)人名；(英)希平 
recalling	1.n. 回顾；召回；回想 2.v. 召回；回想起；回收；使恢复（recall的ing形式） 
popularly	1.adv. 流行地；通俗地；普及地；大众地 
softening	1.n. [油脂] 软化；变软 2.v. 使…变柔软（soften的ing形式） 
edgy	1.adj. 急躁的；尖利的；刀口锐利的 
expats	1.n. 亡命国外者（expat的复数形式） 2.v. 移居国外；放逐（expat的第三人称单数形式） 
quip	1.n. 妙语；嘲弄；讽刺语 2.vi. 嘲弄；讥讽 3.vt. 嘲弄 
